geoid,ct,pop,households,grp_qtrs,inst,pop_u18,hisp,white,black,asian,other_race,multiracial,housing,occupied,vacant
36005000100,2000100,3772,27,3745,3745,12,1259,260,2172,59,12,10,1,0,1
36005000200,2000200,4779,4771,8,0,1065,3173,152,1011,202,115,126,1594,1517,77
36005000400,2000400,6272,6258,14,0,1337,3972,238,1592,230,91,149,2200,2110,90
36005001600,2001600,5795,5565,230,205,1251,3479,121,1884,122,81,108,2129,2042,87
36005001901,2001901,2292,2258,34,0,567,1089,250,803,39,35,76,1049,988,61
36005001902,2001902,1613,1045,568,0,293,854,165,524,13,21,36,523,484,39
36005001903,2001903,2,2,0,0,0,2,0,0,0,0,0,3,3,0
36005001904,2001904,0,0,0,0,0,0,0,0,0,0,0,0,0,0
36005002001,2002001,5007,4855,152,0,1394,3023,68,1755,21,59,81,1895,1864,31
36005002002,2002002,4584,4584,0,0,1140,3058,66,1169,78,112,101,1624,1561,63
36005002300,2002300,4742,4735,7,0,1265,3045,67,1473,19,57,81,1901,1867,34
36005002400,2002400,6,6,0,0,1,3,1,0,0,0,2,2,2,0
36005002500,2002500,5442,5342,100,0,1491,4135,105,1048,53,26,75,1958,1872,86
36005002701,2002701,3080,3038,42,0,910,2063,35,900,28,15,39,1206,1093,113
36005002702,2002702,4995,4373,622,0,1571,3318,94,1398,55,38,92,1576,1510,66
36005002800,2002800,5853,5845,8,0,1045,1647,89,3889,38,39,151,2629,2581,48
36005003100,2003100,2964,2964,0,0,916,1780,35,1014,58,32,45,1120,1086,34
36005003300,2003300,3689,3521,168,0,1038,2453,55,1066,16,30,69,1288,1207,81
36005003500,2003500,3726,3654,72,0,959,2592,122,924,25,32,31,1360,1284,76
36005003700,2003700,340,306,34,0,87,194,5,123,0,6,12,136,128,8
36005003800,2003800,1683,1497,186,0,521,1082,18,475,49,27,32,530,515,15
36005003900,2003900,6345,6069,276,0,1535,5107,249,823,37,65,64,2159,2041,118
36005004001,2004001,1739,1739,0,0,380,740,125,220,566,29,59,613,589,24
36005004100,2004100,6146,6109,37,0,1698,4083,94,1819,35,37,78,2192,2109,83
36005004200,2004200,7201,7168,33,0,1642,4313,90,2581,63,47,107,2843,2798,45
36005004300,2004300,5883,5666,217,0,1577,4174,130,1409,43,33,94,2198,2118,80
36005004400,2004400,4642,4467,175,175,1138,2809,88,1437,180,54,74,1752,1711,41
36005004600,2004600,1976,1900,76,0,516,1187,53,673,4,14,45,743,728,15
36005004800,2004800,4184,4021,163,0,1093,3263,64,646,67,95,49,1358,1328,30
36005005001,2005001,4960,4793,167,0,1470,3463,81,1191,95,68,62,1630,1551,79
36005005002,2005002,6518,6090,428,0,1944,4973,104,1051,139,133,118,2047,1937,110
36005005100,2005100,6459,6341,118,0,1712,3963,163,2131,55,48,99,2490,2434,56
36005005200,2005200,2130,2130,0,0,549,1483,20,543,34,25,25,879,820,59
36005005300,2005300,4371,4371,0,0,1402,2038,38,2092,12,50,141,1662,1628,34
36005005400,2005400,6804,6783,21,0,1875,4750,81,1282,370,182,139,2037,1964,73
36005005600,2005600,2863,2863,0,0,720,1958,30,618,62,125,70,1054,1005,49
36005005902,2005902,2577,2577,0,0,497,1641,224,592,37,23,60,1172,1057,115
36005006000,2006000,1262,1259,3,0,315,1013,16,196,11,15,11,428,408,20
36005006100,2006100,3444,3440,4,0,474,708,33,2580,24,18,81,1893,1821,72
36005006200,2006200,6769,6732,37,0,1842,4455,102,1860,117,129,106,2471,2403,68
36005006301,2006301,6567,6244,323,0,1526,4292,323,1579,191,63,119,2498,2414,84
36005006302,2006302,19,0,19,0,1,15,0,4,0,0,0,0,0,0
36005006400,2006400,4186,4160,26,0,990,2227,106,1225,312,185,131,1438,1341,97
36005006500,2006500,6251,6013,238,36,1679,4045,225,1704,69,101,107,2294,2229,65
36005006700,2006700,6893,6749,144,0,1823,4895,117,1687,52,69,73,2439,2365,74
36005006800,2006800,3419,3419,0,0,902,1899,60,814,397,149,100,1188,1124,64
36005006900,2006900,6964,6845,119,0,1821,4179,124,2440,72,49,100,2644,2555,89
36005007000,2007000,5021,4911,110,0,1222,2616,105,884,1051,217,148,1605,1508,97
36005007100,2007100,2789,2786,3,0,674,1584,66,1003,61,23,52,1134,1121,13
36005007200,2007200,6291,6245,46,0,1543,2498,309,685,2535,146,118,1968,1913,55
36005007300,2007300,4205,4053,152,0,1239,2804,80,1165,19,62,75,1470,1435,35
36005007400,2007400,3536,3536,0,0,712,2047,57,1194,132,29,77,1466,1406,60
36005007500,2007500,6749,6431,318,0,1814,4218,199,2080,72,75,105,2422,2363,59
36005007600,2007600,5682,5682,0,0,1439,3588,170,946,697,167,114,1915,1821,94
36005007700,2007700,1974,1919,55,0,499,1445,61,410,14,12,32,653,628,25
36005007800,2007800,7037,7016,21,0,1809,3969,230,995,1481,201,161,2324,2230,94
36005007900,2007900,6826,6665,161,0,1869,4889,101,1622,67,60,87,2425,2320,105
36005008300,2008300,6122,5968,154,13,1614,4849,72,1048,48,52,53,2161,2084,77
36005008400,2008400,2587,2574,13,13,605,1439,33,830,206,55,24,817,771,46
36005008500,2008500,5894,5350,544,0,1628,4288,141,1245,59,70,91,2052,1936,116
36005008600,2008600,4145,4141,4,0,1048,2457,35,1401,106,75,71,1507,1475,32
36005008700,2008700,5976,5762,214,109,1604,4334,84,1397,15,72,74,2057,1991,66
36005008900,2008900,3118,2943,175,0,727,2371,88,585,28,29,17,1221,1151,70
36005009000,2009000,3911,3668,243,0,1064,2488,60,1141,86,75,61,1303,1249,54
36005009200,2009200,6271,6271,0,0,1570,3031,385,830,1581,242,202,2200,2121,79
36005009301,2009301,5551,5445,106,6,1483,4031,85,1281,33,45,76,1905,1810,95
36005009302,2009302,512,39,473,0,25,195,32,263,14,3,5,10,10,0
36005009600,2009600,2946,2742,204,204,669,1451,191,392,690,142,80,902,859,43
36005009800,2009800,5903,5877,26,0,1254,3638,171,1185,507,226,176,2123,2060,63
36005011000,2011000,0,0,0,0,0,0,0,0,0,0,0,0,0,0
36005011502,2011502,4396,4116,280,0,1347,3055,44,1186,28,28,55,1509,1433,76
36005011701,2011701,1554,1538,16,0,406,1063,15,437,5,4,30,593,584,9
36005011702,2011702,0,0,0,0,0,0,0,0,0,0,0,0,0,0
36005011800,2011800,5324,4110,1214,31,776,1511,3338,148,177,42,108,1794,1676,118
36005011900,2011900,5703,5640,63,22,1427,4008,125,1429,25,50,66,2038,1962,76
36005012101,2012101,3319,3129,190,22,853,2234,53,909,26,45,52,1104,1042,62
36005012102,2012102,1616,1529,87,0,460,1225,20,332,5,11,23,532,508,24
36005012300,2012300,4766,4673,93,0,1275,3126,61,1413,37,55,74,1818,1756,62
36005012500,2012500,4139,4021,118,0,1180,2608,75,1316,23,35,82,1421,1326,95
36005012701,2012701,2184,2139,45,0,520,1567,34,492,45,20,26,852,776,76
36005012901,2012901,4923,4586,337,0,1403,3044,86,1637,24,48,84,1863,1763,100
36005013000,2013000,1198,1198,0,0,222,670,349,116,46,5,12,504,444,60
36005013100,2013100,5390,5142,248,0,1547,3404,105,1687,57,63,74,1948,1886,62
36005013200,2013200,6652,6642,10,0,1298,3764,1573,756,382,84,93,2646,2484,162
36005013300,2013300,6064,6064,0,0,1527,3612,69,2194,32,58,99,2347,2271,76
36005013500,2013500,4001,3908,93,0,1010,2062,50,1781,13,34,61,1508,1430,78
36005013800,2013800,3060,3060,0,0,582,1029,1653,140,113,50,75,1325,1227,98
36005014100,2014100,7344,7168,176,0,2130,3846,149,3062,53,82,152,2977,2790,187
36005014300,2014300,1898,1658,240,0,531,936,63,844,9,22,24,774,749,25
36005014400,2014400,6046,6032,14,0,1550,3927,221,1641,123,63,71,2386,2301,85
36005014500,2014500,7055,6505,550,237,2067,3641,116,3107,11,45,135,2406,2331,75
36005014701,2014701,6361,6047,314,0,1978,3287,41,2884,6,41,102,2048,2014,34
36005014702,2014702,5081,5081,0,0,1543,2931,36,1985,6,45,78,1668,1648,20
36005014900,2014900,4723,4590,133,72,1154,2850,104,1617,12,55,85,1796,1699,97
36005015100,2015100,5957,5803,154,0,1602,3164,123,2512,18,52,88,2075,1981,94
36005015200,2015200,2593,2593,0,0,530,1538,664,207,88,58,38,1028,950,78
36005015300,2015300,4258,4176,82,0,1060,2077,72,1919,77,47,66,1645,1550,95
36005015500,2015500,2891,2835,56,0,659,2188,33,579,25,21,45,1101,1045,56
36005015700,2015700,5542,5455,87,0,1633,3193,78,2087,45,75,64,2367,1957,410
36005015800,2015800,1442,1320,122,0,260,775,513,72,40,13,29,521,479,42
36005015900,2015900,2481,2481,0,0,640,2054,23,341,16,13,34,914,906,8
36005016000,2016000,4003,4003,0,0,750,1513,1947,165,219,88,71,1703,1586,117
36005016100,2016100,5243,4931,312,0,1304,3322,116,1650,21,48,86,2185,2125,60
36005016200,2016200,1908,1717,191,191,369,915,708,96,114,45,30,659,622,37
36005016300,2016300,34,34,0,0,3,18,5,10,0,0,1,36,36,0
36005016400,2016400,1221,1206,15,0,224,559,523,42,65,22,10,511,468,43
36005016500,2016500,1097,924,173,0,268,520,17,517,14,16,13,370,355,15
36005016600,2016600,2625,2596,29,20,569,1541,556,234,196,46,52,911,862,49
36005016700,2016700,3373,2948,425,0,1136,1577,65,1611,16,26,78,1060,1027,33
36005016900,2016900,1586,1370,216,0,451,674,20,834,16,6,36,546,496,50
36005017100,2017100,10,10,0,0,2,1,0,7,0,0,2,2,0,2
36005017300,2017300,6395,6201,194,0,1710,3933,98,2149,61,60,94,2270,2208,62
36005017500,2017500,6988,6819,169,24,1825,4045,141,2594,28,78,102,2747,2652,95
36005017701,2017701,4754,4107,647,399,1328,2871,224,1502,39,38,80,1361,1276,85
36005017702,2017702,4979,4874,105,0,1282,2930,67,1758,75,70,79,1752,1643,109
36005017901,2017901,5124,5114,10,0,1377,3726,66,1042,201,54,35,1714,1660,54
36005017902,2017902,3447,3427,20,0,914,2130,51,1198,14,16,38,1223,1168,55
36005018101,2018101,3299,3280,19,0,852,1892,72,1219,28,20,68,1094,1035,59
36005018102,2018102,5510,5211,299,229,1361,3058,130,1952,254,34,82,1748,1666,82
36005018301,2018301,4423,4423,0,0,794,2474,262,1292,233,61,101,2014,1930,84
36005018302,2018302,3686,3681,5,0,921,2238,45,1226,44,47,86,1320,1290,30
36005018400,2018400,4329,4329,0,0,907,1955,1804,211,252,46,61,1703,1604,99
36005018501,2018501,3076,2865,211,24,840,1436,70,1463,24,34,49,1203,1168,35
36005018502,2018502,6442,5928,514,0,1697,3606,144,2478,32,64,118,2142,2082,60
36005018900,2018900,8360,7939,421,92,2020,5509,222,2347,66,81,135,3147,3005,142
36005019300,2019300,6020,6013,7,0,1591,3769,97,1967,61,49,77,2357,2276,81
36005019400,2019400,2022,2022,0,0,425,1294,304,254,84,43,43,791,742,49
36005019500,2019500,7509,7374,135,0,1749,4927,201,2134,68,61,118,2699,2642,57
36005019700,2019700,7213,7064,149,0,1943,5066,59,1403,513,79,93,2235,2199,36
36005019900,2019900,7909,7865,44,0,1987,5663,134,1918,49,67,78,2900,2771,129
36005020000,2020000,5235,5040,195,44,1424,2501,278,474,1834,68,80,1674,1614,60
36005020100,2020100,4345,3855,490,0,1125,2777,99,1313,41,51,64,1494,1463,31
36005020200,2020200,2789,2771,18,0,735,1464,240,242,720,61,62,949,917,32
36005020400,2020400,3129,3060,69,0,771,1756,196,314,707,92,64,1089,1017,72
36005020501,2020501,7859,7525,334,0,2040,5086,99,2492,11,72,99,2863,2803,60
36005020502,2020502,2462,2430,32,13,532,1638,42,719,15,22,26,990,948,42
36005020601,2020601,3277,3248,29,11,752,1587,243,347,927,61,112,1090,1036,54
36005020900,2020900,4823,4576,247,0,1172,3164,108,1407,35,56,53,1845,1777,68
36005021001,2021001,8946,8934,12,0,1756,3069,232,4001,1323,101,220,4013,3864,149
36005021002,2021002,7855,7840,15,0,1663,2462,188,3306,1635,84,180,3396,3285,111
36005021100,2021100,5822,5555,267,0,1596,3713,79,1899,30,35,66,2071,1948,123
36005021200,2021200,6596,6596,0,0,1422,1694,143,2028,2509,72,150,2680,2595,85
36005021301,2021301,1264,1264,0,0,305,960,18,246,5,16,19,474,449,25
36005021302,2021302,5830,5830,0,0,1462,3628,44,2043,29,43,43,2233,2163,70
36005021501,2021501,4078,4078,0,0,1070,3005,49,929,21,28,46,1405,1365,40
36005021502,2021502,6360,5972,388,0,1663,4385,104,1677,9,84,101,2255,2184,71
36005021601,2021601,4701,4669,32,0,1283,2835,304,984,394,77,107,1694,1645,49
36005021602,2021602,6237,6232,5,0,1292,1967,168,2037,1806,111,148,2624,2522,102
36005021700,2021700,5006,4755,251,0,1192,2664,122,1998,49,58,115,1822,1746,76
36005021800,2021800,6610,6583,27,0,1641,4278,206,1485,340,156,145,2415,2281,134
36005021900,2021900,1176,1087,89,0,241,916,32,192,16,8,12,360,352,8
36005022000,2022000,2511,2166,345,0,642,1654,82,626,51,44,54,771,726,45
36005022101,2022101,4001,4001,0,0,1136,2969,34,793,114,45,46,1308,1291,17
36005022102,2022102,5457,5208,249,0,1611,4609,53,660,38,54,43,1650,1627,23
36005022200,2022200,3968,3922,46,14,1010,1891,176,416,1277,111,97,1294,1228,66
36005022300,2022300,5063,5063,0,0,1170,4053,74,772,34,65,65,1834,1799,35
36005022401,2022401,2787,2773,14,0,599,1805,333,365,208,25,51,1157,1121,36
36005022403,2022403,3275,3270,5,0,706,2145,414,518,116,16,66,1345,1298,47
36005022404,2022404,4489,4448,41,0,956,2383,742,825,375,76,88,1871,1818,53
36005022500,2022500,8141,7077,1064,0,2394,5717,126,2042,90,82,84,2371,2277,94
36005022701,2022701,5669,5424,245,0,1527,3574,65,1838,57,70,65,1848,1807,41
36005022702,2022702,1634,1628,6,0,395,1106,35,373,44,39,37,557,537,20
36005022703,2022703,1699,1699,0,0,387,1278,39,236,95,20,31,604,582,22
36005022800,2022800,6336,6336,0,0,1409,3284,1188,922,744,91,107,2508,2418,90
36005022901,2022901,5766,5621,145,0,1626,3844,125,1370,216,98,113,2032,1939,93
36005022902,2022902,3401,3366,35,0,893,2499,48,747,35,29,43,1184,1130,54
36005023000,2023000,3001,2988,13,0,797,1627,549,371,262,43,149,1052,1010,42
36005023100,2023100,1464,1303,161,144,377,1011,11,423,2,10,7,440,428,12
36005023200,2023200,3000,3000,0,0,777,1460,695,325,317,43,160,987,915,72
36005023301,2023301,4577,4268,309,0,1080,3008,78,1310,36,75,70,1547,1487,60
36005023302,2023302,3574,3501,73,0,900,2901,43,544,19,46,21,1113,1075,38
36005023501,2023501,3570,3556,14,0,894,2915,33,517,14,38,53,1199,1166,33
36005023502,2023502,4417,4307,110,0,982,3339,47,836,94,58,43,1700,1603,97
36005023600,2023600,2204,2155,49,11,566,1146,497,251,133,33,144,713,683,30
36005023702,2023702,1179,1075,104,0,257,900,27,212,17,15,8,361,346,15
36005023703,2023703,5086,4767,319,0,1325,3807,141,992,52,46,48,1644,1589,55
36005023704,2023704,3970,3918,52,0,1098,2956,51,827,17,49,70,1372,1336,36
36005023800,2023800,2750,2741,9,0,701,1425,655,237,247,69,117,946,871,75
36005023900,2023900,8213,7761,452,0,2366,6331,86,1500,155,64,77,2641,2532,109
36005024000,2024000,4583,4524,59,0,1286,2839,392,914,203,128,107,1453,1359,94
36005024100,2024100,6331,6124,207,0,1673,4078,100,1936,49,76,92,2174,2061,113
36005024300,2024300,5577,5559,18,0,1298,3988,92,1266,68,77,86,2072,2004,68
36005024400,2024400,2407,2407,0,0,546,1051,879,113,274,24,66,925,861,64
36005024501,2024501,5059,4864,195,63,1276,3917,76,923,26,45,72,1677,1641,36
36005024502,2024502,3797,3790,7,0,994,2884,26,787,27,36,37,1239,1197,42
36005024600,2024600,2297,2297,0,0,492,870,863,171,313,24,56,867,818,49
36005024700,2024700,1921,1905,16,0,450,923,53,866,40,17,22,765,747,18
36005024800,2024800,3620,3284,336,297,682,1210,1508,302,488,28,84,1324,1258,66
36005024900,2024900,4,4,0,0,3,0,0,0,0,0,4,2,2,0
36005025000,2025000,2672,2656,16,0,515,775,1397,48,374,19,59,1083,1023,60
36005025100,2025100,6924,6912,12,0,1756,4714,99,1408,571,45,87,2310,2232,78
36005025200,2025200,2682,2682,0,0,579,896,1130,196,371,44,45,1059,988,71
36005025300,2025300,6234,6060,174,0,1556,4756,100,1001,204,88,85,1999,1939,60
36005025400,2025400,2163,2157,6,0,425,749,1018,79,213,60,44,903,850,53
36005025500,2025500,8092,6599,1493,0,1707,5871,544,1245,274,67,91,2257,2178,79
36005025600,2025600,1908,1855,53,53,363,922,466,241,193,42,44,713,676,37
36005025700,2025700,1809,1809,0,0,359,1421,47,283,16,22,20,689,675,14
36005026100,2026100,2060,2009,51,0,253,830,140,937,79,20,54,1113,1029,84
36005026300,2026300,6788,6167,621,600,1412,5440,283,748,124,88,105,2350,2240,110
36005026400,2026400,5693,5687,6,0,1127,2586,1965,404,561,56,121,2288,2207,81
36005026500,2026500,7166,6997,169,54,1763,5590,212,753,455,86,70,2248,2224,24
36005026601,2026601,3328,3315,13,0,613,1701,1096,235,225,23,48,1513,1445,68
36005026602,2026602,6409,6394,15,0,1354,3425,1858,505,448,56,117,2876,2741,135
36005026701,2026701,3983,3964,19,0,1026,2917,161,316,507,35,47,1402,1316,86
36005026702,2026702,7022,7009,13,0,1665,5627,287,842,102,102,62,2516,2432,84
36005026900,2026900,4126,4066,60,0,889,3089,156,709,89,38,45,1661,1605,56
36005027300,2027300,7939,7658,281,224,1809,6083,523,1037,104,79,113,2808,2690,118
36005027401,2027401,5136,5136,0,0,1017,1538,3067,124,241,58,108,2010,1893,117
36005027402,2027402,3553,3402,151,124,582,894,2390,94,113,21,41,1461,1369,92
36005027600,2027600,23,17,6,0,7,10,5,5,3,0,0,1,1,0
36005027700,2027700,4968,4962,6,0,1099,3786,399,553,114,53,63,1866,1792,74
36005027900,2027900,8145,7760,385,369,1696,5246,1280,988,340,98,193,3230,3104,126
36005028100,2028100,3720,3491,229,203,503,1846,1091,548,120,29,86,1816,1686,130
36005028300,2028300,2084,2077,7,0,478,1432,141,386,45,45,35,866,846,20
36005028400,2028400,297,63,234,166,44,113,56,93,3,25,7,24,24,0
36005028500,2028500,3440,3428,12,0,571,1482,1384,221,222,33,98,1743,1654,89
36005028600,2028600,1395,1395,0,0,321,445,619,66,206,32,27,580,530,50
36005028700,2028700,3953,3715,238,0,973,2510,670,320,328,46,79,1374,1322,52
36005028800,2028800,3055,3045,10,0,510,614,1833,92,441,45,30,1254,1183,71
36005028900,2028900,4736,4618,118,112,978,3325,819,287,198,31,76,1934,1843,91
36005029301,2029301,1954,1762,192,192,196,392,1265,97,96,9,95,1033,958,75
36005029302,2029302,5248,5134,114,114,765,1136,3034,534,300,68,176,2892,2702,190
36005029500,2029500,4615,4598,17,0,896,1433,2238,342,356,57,189,2245,2098,147
36005029600,2029600,2878,1966,912,28,353,782,936,367,667,43,83,1014,986,28
36005029700,2029700,4005,3605,400,322,737,922,2337,246,313,54,133,1848,1659,189
36005030000,2030000,6591,6571,20,0,1336,3214,2062,492,580,93,150,2837,2716,121
36005030100,2030100,1627,1271,356,332,239,455,823,174,109,23,43,680,652,28
36005030201,2030201,4048,4039,9,0,650,1032,212,2601,49,49,105,1864,1810,54
36005030202,2030202,6063,6022,41,0,977,1464,208,4116,71,42,162,2747,2667,80
36005030701,2030701,5799,5775,24,0,1215,1026,3998,325,224,70,156,2949,2726,223
36005030900,2030900,3947,2773,1174,808,590,707,2628,329,141,69,73,1419,1286,133
36005031000,2031000,4372,3710,662,628,737,1612,1212,729,636,50,133,1290,1224,66
36005031200,2031200,1555,1555,0,0,284,555,483,241,213,39,24,598,565,33
36005031400,2031400,2071,1882,189,177,399,757,625,263,333,27,66,694,638,56
36005031600,2031600,2071,2053,18,0,419,675,672,291,354,43,36,721,694,27
36005031800,2031800,1961,1807,154,154,341,702,587,295,286,41,50,660,611,49
36005031900,2031900,454,44,410,0,13,136,206,66,17,24,5,13,12,1
36005032300,2032300,5001,4941,60,15,673,1249,2737,538,262,60,155,2909,2694,215
36005032400,2032400,3113,3088,25,10,718,1531,439,847,149,46,101,1315,1266,49
36005032600,2032600,3494,3298,196,181,670,1101,1099,452,710,50,82,1224,1160,64
36005032800,2032800,4133,4120,13,0,1033,2150,727,794,314,31,117,1526,1481,45
36005033000,2033000,5837,5808,29,4,1375,2672,1671,980,344,75,95,2228,2149,79
36005033201,2033201,4103,4041,62,0,838,2565,628,691,106,46,67,1928,1822,106
36005033202,2033202,4204,3800,404,404,799,2324,460,1130,167,45,78,1657,1598,59
36005033400,2033400,69,56,13,0,18,30,6,31,0,1,1,23,20,3
36005033500,2033500,2440,1968,472,104,444,477,1578,153,120,25,87,884,834,50
36005033601,2033601,4306,4306,0,0,971,2182,116,1743,96,72,97,2001,1889,112
36005033602,2033602,1555,1544,11,0,344,747,92,670,8,15,23,645,621,24
36005033700,2033700,3838,3693,145,0,730,747,2094,159,561,70,207,1288,1182,106
36005033801,2033801,2337,2337,0,0,596,1068,168,860,145,51,45,820,780,40
36005033802,2033802,1737,1737,0,0,442,698,78,817,64,31,49,661,632,29
36005034000,2034000,4858,4819,39,0,1103,2305,422,1647,274,68,142,1803,1743,60
36005034200,2034200,1732,1702,30,13,377,635,103,826,93,35,40,621,586,35
36005034300,2034300,1706,1489,217,185,343,719,605,212,92,25,53,638,612,26
36005034400,2034400,1930,1914,16,0,420,736,96,870,162,23,43,691,652,39
36005034500,2034500,3754,3502,252,220,635,1267,1443,564,299,58,123,1738,1603,135
36005034800,2034800,6640,6596,44,0,1543,2577,274,3263,277,108,141,2291,2220,71
36005035000,2035000,2284,2284,0,0,550,620,109,1227,195,50,83,765,723,42
36005035100,2035100,3539,2591,948,0,522,1174,1680,335,202,27,121,1276,1199,77
36005035600,2035600,2261,2247,14,5,457,522,79,1482,72,36,70,780,752,28
36005035800,2035800,7542,7456,86,0,1562,1527,98,5478,131,114,194,2702,2543,159
36005035900,2035900,3731,3714,17,0,1014,2333,59,1178,83,41,37,1670,1573,97
36005036000,2036000,3024,2821,203,173,561,955,341,1320,233,59,116,1017,972,45
36005036100,2036100,5569,5551,18,18,1261,4055,42,1259,58,40,115,2384,2232,152
36005036300,2036300,7074,6964,110,17,1877,5051,91,1761,27,59,85,2594,2490,104
36005036400,2036400,2603,2582,21,0,528,463,33,1974,54,19,60,953,856,97
36005036501,2036501,3897,3700,197,0,1055,2085,26,1683,13,38,52,1460,1391,69
36005036502,2036502,2449,2386,63,0,657,1623,52,672,22,44,36,862,813,49
36005036700,2036700,2672,2105,567,0,847,1605,72,887,26,53,29,807,679,128
36005036800,2036800,2165,1997,168,0,553,565,29,1435,47,46,43,701,662,39
36005036901,2036901,1910,1829,81,0,512,1405,27,423,10,27,18,744,707,37
36005036902,2036902,2324,2049,275,0,625,1320,52,870,7,15,60,828,738,90
36005037000,2037000,2536,2536,0,0,564,727,50,1535,114,38,72,930,877,53
36005037100,2037100,4504,4283,221,0,1048,2846,68,1476,10,38,66,1842,1775,67
36005037200,2037200,2289,2251,38,0,514,826,67,1193,78,59,66,867,815,52
36005037300,2037300,6117,6054,63,0,1752,3904,109,1880,43,56,125,2242,2147,95
36005037400,2037400,3890,3890,0,0,1056,1755,92,1828,61,35,119,1601,1533,68
36005037504,2037504,4023,3689,334,173,1058,2485,112,1308,20,35,63,1441,1389,52
36005037600,2037600,2274,2197,77,0,476,989,124,962,100,42,57,849,803,46
36005037800,2037800,3569,3487,82,0,850,1330,120,1930,32,55,102,1306,1262,44
36005037900,2037900,6878,6287,591,0,2207,3319,122,3171,42,104,120,2336,2241,95
36005038000,2038000,4938,4731,207,0,1153,1248,110,3305,109,59,107,2064,1880,184
36005038100,2038100,6853,6781,72,0,1757,5093,112,1430,82,79,57,2394,2329,65
36005038200,2038200,2852,2852,0,0,662,618,47,2049,20,30,88,1001,946,55
36005038301,2038301,4635,4586,49,0,1127,3344,82,1051,66,41,51,1613,1578,35
36005038303,2038303,3468,3468,0,0,908,1820,36,1479,13,40,80,1270,1227,43
36005038304,2038304,2508,2190,318,0,804,1684,61,704,13,11,35,788,748,40
36005038500,2038500,5362,5319,43,0,1607,3312,124,1706,30,70,120,2044,1963,81
36005038600,2038600,7949,7916,33,0,1931,1246,77,6266,73,86,201,2907,2813,94
36005038700,2038700,3401,3353,48,0,897,2111,355,765,88,25,57,1368,1259,109
36005038800,2038800,2941,2919,22,0,736,651,48,2127,18,23,74,1003,941,62
36005038900,2038900,4819,4660,159,0,1184,2943,913,650,151,53,109,1898,1699,199
36005039000,2039000,3323,3323,0,0,832,857,54,2238,65,45,64,1184,1094,90
36005039100,2039100,7210,7151,59,0,1955,5414,560,986,105,73,72,2698,2534,164
36005039200,2039200,1809,1750,59,47,405,557,37,1124,14,20,57,665,625,40
36005039300,2039300,8033,7831,202,0,2212,5230,261,2307,33,86,116,3265,3151,114
36005039400,2039400,4647,4436,211,187,1098,1655,151,2606,64,83,88,1717,1650,67
36005039500,2039500,4254,4053,201,0,1088,2629,81,1419,30,48,47,1713,1583,130
36005039600,2039600,4485,4399,86,0,1092,1177,58,2999,80,51,120,1601,1503,98
36005039700,2039700,4492,1353,3139,0,274,1143,2458,325,318,49,199,597,545,52
36005039800,2039800,3347,3338,9,0,815,575,55,2573,20,35,89,1185,1087,98
36005039901,2039901,5254,5158,96,0,1275,3664,160,959,302,82,87,1753,1674,79
36005039902,2039902,5548,5218,330,0,1545,4081,100,1039,136,123,69,1726,1684,42
36005040100,2040100,5009,4916,93,0,1293,3873,158,713,118,52,95,1819,1581,238
36005040302,2040302,4197,4197,0,0,1089,3453,75,402,154,61,52,1421,1385,36
36005040303,2040303,4843,4723,120,0,1105,3747,132,702,121,65,76,1798,1747,51
36005040304,2040304,4125,4102,23,0,1049,3137,108,517,273,41,49,1413,1384,29
36005040400,2040400,3530,3514,16,0,792,775,39,2549,34,46,87,1236,1154,82
36005040501,2040501,4385,4385,0,0,1115,3274,111,813,62,64,61,1457,1396,61
36005040502,2040502,7320,7062,258,0,1870,4866,175,1870,167,130,112,2553,2441,112
36005040600,2040600,3792,3782,10,0,873,1018,61,2391,93,76,153,1480,1370,110
36005040701,2040701,3235,3215,20,0,717,2465,204,396,91,39,40,1278,1181,97
36005040702,2040702,6968,6808,160,0,1427,4820,514,962,461,114,97,2758,2663,95
36005040800,2040800,4475,4461,14,2,1151,1931,110,2078,166,67,123,1682,1622,60
36005040900,2040900,3580,3580,0,0,649,744,420,2110,217,45,44,1472,1423,49
36005041100,2041100,3215,3192,23,0,753,2302,234,513,102,28,36,1377,1262,115
36005041300,2041300,7781,7581,200,0,1778,5257,857,1164,289,74,140,3094,2963,131
36005041400,2041400,5342,5168,174,12,1070,1474,200,2862,280,289,237,1951,1817,134
36005041500,2041500,5872,5845,27,0,1296,3789,631,861,388,102,101,2408,2339,69
36005041800,2041800,3752,3612,140,0,750,1250,165,1792,207,198,140,1427,1352,75
36005041900,2041900,7205,7120,85,0,1766,4605,566,877,963,101,93,2661,2569,92
36005042000,2042000,3905,3799,106,6,957,1708,98,1771,129,112,87,1548,1498,50
36005042100,2042100,6135,6123,12,0,1413,3776,468,812,864,104,111,2390,2304,86
36005042200,2042200,3211,3204,7,0,677,764,83,2148,65,63,88,1269,1208,61
36005042300,2042300,4179,4160,19,0,1204,2614,431,558,442,68,66,1492,1421,71
36005042400,2042400,2553,2345,208,208,511,517,78,1795,52,40,71,878,820,58
36005042500,2042500,7667,7645,22,0,2101,4496,691,827,1447,81,125,2621,2510,111
36005042600,2042600,6982,6937,45,11,1455,1017,91,5548,86,93,147,2379,2263,116
36005042800,2042800,2230,2230,0,0,460,359,37,1655,29,56,94,794,769,25
36005042901,2042901,3711,3711,0,0,944,2160,244,540,675,36,56,1357,1317,40
36005042902,2042902,4334,4228,106,106,1011,2576,257,1011,356,61,73,1728,1668,60
36005043000,2043000,2952,2952,0,0,581,565,69,2008,95,115,100,1103,1036,67
36005043101,2043101,5185,5139,46,0,1310,2812,236,869,1070,131,67,1910,1864,46
36005043102,2043102,5050,4619,431,392,1061,3531,200,943,232,60,84,1749,1700,49
36005043400,2043400,3649,3614,35,0,807,898,179,2059,159,192,162,1372,1319,53
36005043501,2043501,1192,1187,5,0,409,470,13,624,29,17,39,489,482,7
36005043502,2043502,2,0,2,0,1,0,0,1,0,1,0,0,0,0
36005043503,2043503,122,122,0,0,11,45,29,35,4,1,8,72,72,0
36005043600,2043600,2061,2061,0,0,424,395,56,1373,78,58,101,738,693,45
36005044200,2044200,3877,3854,23,3,886,929,51,2570,95,86,146,1430,1340,90
36005044400,2044400,3984,3980,4,0,830,583,100,3047,55,109,90,1456,1347,109
36005044800,2044800,2007,1999,8,0,376,268,30,1581,35,36,57,739,699,40
36005044901,2044901,1946,1932,14,14,363,368,1348,132,30,15,53,935,856,79
36005044902,2044902,2229,2203,26,26,356,486,1499,157,33,13,41,1014,958,56
36005045101,2045101,1817,1805,12,0,264,318,1229,146,72,4,48,957,892,65
36005045102,2045102,2142,2142,0,0,398,381,1450,162,48,35,66,990,936,54
36005045600,2045600,3056,3038,18,0,614,702,435,1693,48,67,111,1163,1072,91
36005045800,2045800,5662,5662,0,0,1646,3275,44,2181,30,34,98,2144,2102,42
36005046000,2046000,2890,2643,247,247,588,842,42,1861,22,49,74,1067,1011,56
36005046203,2046203,6599,6094,505,461,833,2180,415,3669,109,55,171,3068,2987,81
36005046204,2046204,5552,5528,24,0,837,1543,326,3399,68,59,157,2691,2614,77
36005046205,2046205,4445,4431,14,0,648,1335,235,2658,38,37,142,2198,2147,51
36005046206,2046206,4434,4434,0,0,729,1002,194,3011,72,46,109,2207,2136,71
36005046207,2046207,6228,6007,221,0,906,1665,340,3935,83,52,153,3146,3045,101
36005046208,2046208,5155,4496,659,641,994,1192,122,3591,65,60,125,1529,1448,81
36005046209,2046209,3707,3707,0,0,970,1384,19,2137,31,49,87,1400,1357,43
36005048401,2048401,3888,3780,108,25,839,802,65,2830,44,43,104,1354,1286,68
36005048402,2048402,41,38,3,0,9,14,0,20,0,0,7,10,10,0
36005050400,2050400,5,5,0,0,3,2,0,0,0,0,3,2,2,0
36005051601,2051601,4445,4424,21,0,696,1139,2735,210,200,32,129,2223,2065,158
36005051602,2051602,0,0,0,0,0,0,0,0,0,0,0,0,0,0
36047000100,3000100,4616,4615,1,0,744,412,3180,295,448,33,248,2663,2429,234
36047000200,3000200,1205,1171,34,0,286,957,99,57,55,12,25,376,359,17
36047000301,3000301,3850,3776,74,0,657,238,3127,90,209,15,171,2466,1907,559
36047000501,3000501,4404,3403,1001,0,513,310,3329,107,433,28,197,2081,1893,188
36047000502,3000502,2640,2635,5,0,306,177,2057,75,201,8,122,1621,1512,109
36047000700,3000700,4415,4357,58,0,853,390,3188,131,378,28,300,2312,2099,213
36047000900,3000900,5167,4834,333,0,777,434,3565,188,613,49,318,2667,2462,205
36047001100,3001100,1578,1555,23,0,156,178,772,163,375,5,85,957,900,57
36047001300,3001300,2465,2046,419,0,248,276,1171,232,569,36,181,1388,1192,196
36047001501,3001501,5161,4959,202,0,898,997,1293,1279,1341,57,194,2417,2245,172
36047001502,3001502,5801,5448,353,0,593,608,2335,687,1804,46,321,3316,2941,375
36047001801,3001801,2563,0,2563,2562,0,734,898,874,21,1,35,4,0,4
36047001802,3001802,6,6,0,0,3,3,0,0,1,0,2,2,0,2
36047001803,3001803,16,11,5,0,4,5,5,0,4,1,1,3,3,0
36047001804,3001804,0,0,0,0,0,0,0,0,0,0,0,0,0,0
36047002000,3002000,1694,1560,134,0,405,1285,140,145,97,16,11,518,474,44
36047002100,3002100,5975,5975,0,0,1241,541,4113,220,638,61,402,2942,2717,225
36047002200,3002200,4589,4564,25,0,978,2813,761,193,682,75,65,1731,1661,70
36047002300,3002300,3940,3940,0,0,889,1128,69,1926,676,40,101,1526,1495,31
36047002901,3002901,3149,3042,107,0,697,886,103,1433,590,41,96,1385,1294,91
36047003000,3003000,1811,1811,0,0,349,380,966,30,336,29,70,759,708,51
36047003101,3003101,3395,2803,592,373,330,382,1176,830,743,32,232,1630,1551,79
36047003102,3003102,0,0,0,0,0,0,0,0,0,0,0,0,0,0
36047003300,3003300,4807,4777,30,0,699,652,2258,828,702,57,310,2730,2525,205
36047003400,3003400,3489,3468,21,0,732,543,2081,79,653,20,113,1501,1417,84
36047003500,3003500,2402,2350,52,0,310,260,1066,631,259,29,157,1314,1226,88
36047003600,3003600,3959,3936,23,0,662,660,2404,104,653,21,117,1916,1847,69
36047003700,3003700,4565,4543,22,0,528,453,2240,478,1083,58,253,2917,2628,289
36047003800,3003800,1529,1529,0,0,284,165,1054,16,203,17,74,732,683,49
36047003900,3003900,2644,2603,41,0,382,380,1419,351,273,33,188,1451,1353,98
36047004100,3004100,3398,3198,200,175,500,387,2184,290,318,20,199,1607,1480,127
36047004300,3004300,3810,3770,40,0,645,453,2428,233,424,31,241,1978,1831,147
36047004400,3004400,2448,2448,0,0,479,209,1938,20,213,10,58,1037,979,58
36047004500,3004500,3476,3476,0,0,592,263,2674,54,268,28,189,1806,1675,131
36047004600,3004600,1154,1154,0,0,239,110,892,8,100,6,38,474,444,30
36047004700,3004700,1951,1890,61,20,482,352,1143,191,124,19,122,850,799,51
36047004900,3004900,2412,2185,227,227,482,312,1604,173,167,32,124,1078,979,99
36047005000,3005000,2535,2526,9,0,473,298,1915,23,212,15,72,1150,1095,55
36047005100,3005100,2658,2656,2,0,679,402,1754,92,197,27,186,1199,1103,96
36047005201,3005201,1879,1862,17,0,232,142,1350,17,332,8,30,1204,1163,41
36047005202,3005202,2668,2644,24,0,399,264,2068,38,197,16,85,1514,1435,79
36047005301,3005301,2164,2142,22,0,443,466,1256,163,119,41,119,1037,941,96
36047005302,3005302,86,76,10,0,12,13,56,2,14,0,1,38,35,3
36047005303,3005303,0,0,0,0,0,0,0,0,0,0,0,69,2,67
36047005400,3005400,3426,3413,13,0,530,564,2347,53,349,19,94,1831,1708,123
36047005601,3005601,2692,2689,3,0,382,415,1907,44,235,33,58,1531,1452,79
36047005602,3005602,1734,1721,13,0,256,221,1264,20,168,13,48,1002,939,63
36047005800,3005800,3450,3450,0,0,622,637,2236,69,380,41,87,1681,1571,110
36047005900,3005900,1742,1569,173,0,286,503,821,269,44,22,83,741,691,50
36047006000,3006000,2876,2868,8,0,579,705,1572,42,422,25,110,1216,1133,83
36047006200,3006200,2958,2919,39,0,557,535,1851,75,374,25,98,1293,1216,77
36047006300,3006300,2007,2007,0,0,479,219,1483,40,133,11,121,985,895,90
36047006400,3006400,3623,3604,19,0,679,720,2254,57,469,27,96,1579,1488,91
36047006500,3006500,5461,5433,28,0,1157,514,4267,81,280,29,290,2696,2441,255
36047006600,3006600,3974,3959,15,0,771,928,2237,76,512,43,178,1717,1617,100
36047006700,3006700,3618,3618,0,0,902,256,2860,35,213,15,239,1604,1481,123
36047006800,3006800,5491,5465,26,7,1334,1486,2607,161,986,80,171,1995,1917,78
36047006901,3006901,1631,1618,13,0,273,175,1189,46,105,7,109,853,779,74
36047006902,3006902,1962,1962,0,0,383,261,1367,57,131,19,127,891,855,36
36047007000,3007000,2454,2426,28,0,429,510,1290,104,458,16,76,1128,1060,68
36047007100,3007100,4362,4362,0,0,994,1481,887,1485,311,50,148,1807,1731,76
36047007200,3007200,2082,2066,16,0,515,1141,264,41,587,4,45,642,618,24
36047007400,3007400,5829,5829,0,0,1547,3629,411,53,1638,35,63,1694,1613,81
36047007500,3007500,4691,4682,9,0,929,535,3483,79,269,41,284,2310,2121,189
36047007600,3007600,4872,4856,16,0,1109,3004,553,76,1099,93,47,1590,1488,102
36047007700,3007700,5690,5665,25,0,1137,588,4111,207,416,36,332,2908,2711,197
36047007800,3007800,5333,5300,33,0,1222,3808,524,168,719,48,66,1722,1639,83
36047008000,3008000,4024,4017,7,0,863,2839,453,104,503,51,74,1462,1400,62
36047008200,3008200,4008,3989,19,0,843,2667,634,112,445,51,99,1485,1409,76
36047008400,3008400,3311,3197,114,0,722,2213,624,153,215,32,74,1128,1063,65
36047008500,3008500,6673,6673,0,0,1715,3152,109,2752,380,81,199,2875,2785,90
36047008600,3008600,0,0,0,0,0,0,0,0,0,0,0,0,0,0
36047008800,3008800,3258,3245,13,0,691,1710,800,101,531,30,86,1227,1154,73
36047009001,3009001,1886,1886,0,0,501,958,216,21,638,16,37,561,539,22
36047009002,3009002,1391,1391,0,0,364,602,115,37,609,3,25,446,431,15
36047009201,3009201,2087,2087,0,0,487,665,301,12,1071,6,32,684,649,35
36047009202,3009202,3424,3424,0,0,832,1394,303,98,1514,49,66,1079,1029,50
36047009401,3009401,3127,3127,0,0,810,661,152,9,2246,33,26,863,820,43
36047009402,3009402,3168,3168,0,0,893,468,621,39,1977,18,45,907,865,42
36047009600,3009600,6462,6441,21,0,1532,3283,804,141,2113,24,97,2045,1935,110
36047009800,3009800,7440,7432,8,0,1991,3342,298,81,3653,29,37,2042,1942,100
36047010000,3010000,7741,7725,16,0,1967,2425,434,71,4701,42,68,2167,2064,103
36047010100,3010100,4590,4184,406,0,976,2343,1430,340,300,55,122,1611,1480,131
36047010200,3010200,6578,6548,30,0,1754,1487,297,46,4690,20,38,1784,1697,87
36047010401,3010401,3015,3015,0,0,757,208,156,18,2600,11,22,933,865,68
36047010402,3010402,2965,2965,0,0,758,214,247,25,2445,0,34,941,859,82
36047010601,3010601,3037,3037,0,0,732,451,134,10,2399,17,26,923,874,49
36047010602,3010602,2820,2820,0,0,649,160,77,3,2554,12,14,824,757,67
36047010801,3010801,2876,2876,0,0,764,396,84,6,2372,5,13,821,768,53
36047010802,3010802,2840,2840,0,0,652,411,240,31,2128,12,18,938,846,92
36047011000,3011000,2709,2709,0,0,824,1142,648,47,789,46,37,806,720,86
36047011200,3011200,6636,6614,22,0,2079,1944,2283,135,1963,147,164,2159,2075,84
36047011400,3011400,4150,3673,477,449,1206,640,1947,184,1113,159,107,1357,1138,219
36047011600,3011600,5529,5505,24,0,1510,558,478,42,4388,25,38,1649,1556,93
36047011700,3011700,2672,2672,0,0,421,729,1425,103,252,29,134,1308,1201,107
36047011800,3011800,2578,2578,0,0,594,283,203,21,2036,20,15,798,771,27
36047011901,3011901,1589,1430,159,0,237,350,879,156,119,17,68,720,653,67
36047011902,3011902,0,0,0,0,0,0,0,0,0,0,0,1,1,0
36047012000,3012000,1176,1176,0,0,296,144,93,3,906,4,26,361,342,19
36047012100,3012100,1916,1914,2,0,295,463,1046,76,222,13,96,952,830,122
36047012200,3012200,5521,5509,12,0,1332,2357,630,73,2394,27,40,1715,1626,89
36047012600,3012600,3085,3085,0,0,722,735,1053,80,1098,16,103,1019,951,68
36047012700,3012700,4036,3802,234,50,692,1183,1117,1265,265,39,167,1782,1700,82
36047012801,3012801,2567,2567,0,0,597,214,494,18,1799,4,38,818,779,39
36047012901,3012901,2333,2333,0,0,343,405,1266,197,272,18,175,1156,1073,83
36047012902,3012902,3318,3298,20,0,498,466,1681,610,319,21,221,1705,1629,76
36047013000,3013000,5347,5283,64,0,1227,1163,2661,141,1100,66,216,2005,1912,93
36047013100,3013100,3979,3933,46,0,655,692,2263,434,328,27,235,1913,1791,122
36047013200,3013200,2870,2870,0,0,712,413,746,17,1617,14,63,870,823,47
36047013300,3013300,4411,4411,0,0,919,525,2919,190,462,23,292,1996,1894,102
36047013400,3013400,4212,4194,18,0,905,839,2168,71,941,40,153,1658,1541,117
36047013500,3013500,3799,3697,102,0,881,454,2447,233,351,33,281,1615,1524,91
36047013600,3013600,4079,4054,25,0,819,830,2446,58,546,40,159,1661,1558,103
36047013700,3013700,3406,3386,20,2,622,506,2176,180,280,35,229,1663,1562,101
36047013800,3013800,3247,3230,17,0,544,665,1937,72,430,49,94,1449,1353,96
36047013900,3013900,3727,3727,0,0,619,625,2280,273,313,21,215,1643,1545,98
36047014000,3014000,2136,2118,18,10,422,288,1418,18,357,21,34,865,820,45
36047014101,3014101,1621,1369,252,0,388,309,829,216,176,10,81,616,573,43
36047014102,3014102,1858,1858,0,0,349,343,1088,67,231,19,110,955,853,102
36047014200,3014200,3434,3423,11,0,641,728,1988,74,535,25,84,1498,1434,64
36047014300,3014300,3705,3705,0,0,646,1072,1903,138,349,43,200,1726,1570,156
36047014500,3014500,4404,4356,48,0,703,1494,2087,209,302,50,262,1966,1857,109
36047014700,3014700,2242,2242,0,0,494,631,1287,77,122,30,95,959,914,45
36047014800,3014800,1244,1244,0,0,222,143,907,4,169,5,16,523,483,40
36047014901,3014901,1529,1470,59,0,301,192,1002,84,139,6,106,701,655,46
36047014902,3014902,3601,3589,12,0,682,655,2260,105,302,28,251,1610,1505,105
36047015000,3015000,1791,1784,7,0,386,218,1045,3,493,1,31,720,667,53
36047015100,3015100,3696,3687,9,0,818,369,2713,105,265,32,212,1684,1564,120
36047015200,3015200,2545,2346,199,179,474,370,1481,36,563,28,67,972,882,90
36047015300,3015300,2633,2624,9,9,575,247,1976,71,198,17,124,1252,1127,125
36047015400,3015400,9,6,3,0,1,2,3,0,0,1,3,1,0,1
36047015500,3015500,3466,3458,8,0,810,277,2625,109,222,18,215,1572,1466,106
36047015700,3015700,4447,4437,10,0,894,325,3339,150,298,52,283,2199,2056,143
36047015900,3015900,5206,5206,0,0,844,378,3802,273,384,65,304,2752,2563,189
36047016000,3016000,4462,4455,7,0,951,1115,2154,142,892,56,103,1851,1773,78
36047016100,3016100,3450,3448,2,0,581,436,2051,380,327,30,226,1637,1549,88
36047016200,3016200,2218,2196,22,0,357,373,1296,130,305,26,88,1161,1046,115
36047016300,3016300,4088,4088,0,0,739,368,2312,664,415,50,279,2037,1907,130
36047016400,3016400,775,775,0,0,273,189,319,105,81,16,65,280,232,48
36047016500,3016500,5080,5064,16,0,1113,427,3825,128,359,57,284,2402,2205,197
36047016600,3016600,1968,1968,0,0,395,120,1548,4,252,10,34,777,727,50
36047016700,3016700,4754,4741,13,0,1064,504,3525,110,275,46,294,2151,2009,142
36047016800,3016800,1695,1695,0,0,338,107,1016,17,527,1,27,750,697,53
36047016900,3016900,4459,4453,6,0,843,797,2694,137,543,47,241,2093,1996,97
36047017000,3017000,3604,3604,0,0,759,406,1587,13,1521,21,56,1345,1227,118
36047017100,3017100,3717,3710,7,0,832,316,2822,69,261,37,212,1668,1544,124
36047017200,3017200,3300,3291,9,0,696,422,1237,46,1518,12,65,1175,1104,71
36047017400,3017400,1950,1950,0,0,418,237,938,9,720,15,31,778,713,65
36047017500,3017500,5,5,0,0,2,2,0,0,2,0,1,5,5,0
36047017600,3017600,2418,2418,0,0,482,454,970,30,911,12,41,964,907,57
36047017700,3017700,15,13,2,0,4,5,2,7,0,0,1,7,7,0
36047017800,3017800,2959,2770,189,178,629,545,966,45,1336,10,57,978,909,69
36047017900,3017900,3895,3574,321,321,610,590,954,1818,291,31,211,1611,1567,44
36047018000,3018000,3125,3125,0,0,704,681,1033,36,1313,13,49,1139,1035,104
36047018100,3018100,4204,4181,23,16,595,367,2477,764,334,40,222,2374,2226,148
36047018200,3018200,3745,3745,0,0,829,523,924,17,2196,16,69,1282,1177,105
36047018300,3018300,2784,2784,0,0,527,306,1630,425,156,39,228,1390,1255,135
36047018400,3018400,2460,2460,0,0,447,146,895,7,1360,0,52,925,865,60
36047018501,3018501,4461,4385,76,0,1128,1332,316,2138,493,41,141,1798,1732,66
36047018600,3018600,2364,2364,0,0,457,287,809,20,1216,5,27,825,782,43
36047018700,3018700,1336,1305,31,0,227,217,667,236,102,34,80,650,570,80
36047018800,3018800,2955,2948,7,0,555,526,1121,19,1243,23,23,1067,997,70
36047019000,3019000,4853,4835,18,0,1069,1353,1262,61,2087,33,57,1717,1616,101
36047019100,3019100,3427,3356,71,0,600,570,1634,562,411,60,190,1640,1472,168
36047019200,3019200,3541,3528,13,0,1221,677,1492,23,1194,104,51,955,892,63
36047019300,3019300,6279,4629,1650,0,674,891,1942,2073,973,141,259,2736,2503,233
36047019400,3019400,3570,3557,13,0,762,804,681,32,1995,5,53,1236,1139,97
36047019500,3019500,3684,3670,14,0,517,509,1773,899,236,72,195,1919,1807,112
36047019600,3019600,4691,4469,222,123,1017,973,1541,38,2050,17,72,1639,1542,97
36047019700,3019700,3585,3568,17,0,595,312,1879,866,249,25,254,1842,1696,146
36047019800,3019800,2061,2061,0,0,439,322,900,22,765,18,34,748,680,68
36047019900,3019900,3978,3978,0,0,530,472,1838,1039,349,38,242,2304,2053,251
36047020000,3020000,2442,2442,0,0,583,419,1005,24,936,15,43,851,795,56
36047020100,3020100,3862,3852,10,0,606,324,2037,1020,220,41,220,2084,1774,310
36047020200,3020200,2147,2147,0,0,465,220,1062,21,802,10,32,760,716,44
36047020300,3020300,2132,2064,68,0,376,295,1070,324,264,41,138,961,893,68
36047020400,3020400,2040,2040,0,0,459,144,1115,0,732,15,34,736,688,48
36047020500,3020500,3405,3405,0,0,600,295,1942,555,312,50,251,1700,1616,84
36047020600,3020600,2505,2482,23,0,533,381,1214,14,854,6,36,891,827,64
36047020700,3020700,4871,4871,0,0,808,495,2745,911,366,65,289,2368,2253,115
36047020800,3020800,3782,3782,0,0,871,430,1111,34,2159,4,44,1247,1171,76
36047021000,3021000,4488,4488,0,0,1003,562,1130,26,2657,24,89,1511,1419,92
36047021100,3021100,2505,2502,3,0,444,613,708,793,246,38,107,1264,1147,117
36047021200,3021200,5278,5234,44,0,1180,691,950,79,3499,29,30,1677,1599,78
36047021300,3021300,3880,3861,19,0,517,434,857,2177,132,49,231,1865,1790,75
36047021400,3021400,2502,2502,0,0,864,184,1017,12,1185,69,35,697,655,42
36047021500,3021500,5569,5569,0,0,806,556,2552,1686,357,48,370,2751,2627,124
36047021600,3021600,4280,4263,17,0,1803,208,3141,23,661,138,109,1129,1063,66
36047021700,3021700,4351,4348,3,0,694,718,1377,1585,355,37,279,2074,1952,122
36047021800,3021800,4191,4106,85,0,1775,439,3162,43,258,210,79,1123,1046,77
36047021900,3021900,4225,4159,66,0,474,395,1594,1633,294,28,281,2095,1907,188
36047022000,3022000,5660,5633,27,0,2516,399,4419,31,350,365,96,1493,1419,74
36047022100,3022100,3897,3706,191,0,423,565,1321,1495,215,76,225,1914,1702,212
36047022200,3022200,5633,5633,0,0,2513,506,4407,82,183,285,170,1558,1466,92
36047022400,3022400,6117,6077,40,0,2702,917,4282,34,596,195,93,1564,1430,134
36047022600,3022600,2664,2568,96,0,1019,1027,984,65,435,72,81,665,613,52
36047022700,3022700,4515,4426,89,0,677,545,1446,1816,338,52,318,2252,2007,245
36047022800,3022800,3638,3594,44,26,1391,423,2008,112,927,103,65,966,911,55
36047022900,3022900,3923,3885,38,12,577,376,1629,1358,262,42,256,1901,1715,186
36047023000,3023000,4442,4442,0,0,1930,888,2948,67,352,134,53,1191,1065,126
36047023100,3023100,3832,3812,20,0,527,386,1742,1115,276,40,273,1875,1755,120
36047023200,3023200,6382,6380,2,0,2920,398,5038,50,483,270,143,1709,1528,181
36047023300,3023300,5961,5961,0,0,1450,1223,1720,2304,420,60,234,2317,2183,134
36047023400,3023400,5923,5904,19,0,2742,107,5299,40,77,274,126,1670,1564,106
36047023500,3023500,5921,5897,24,0,2389,755,3948,532,360,154,172,1775,1678,97
36047023600,3023600,6548,6548,0,0,3012,78,5712,8,278,327,145,1844,1752,92
36047023800,3023800,5414,5414,0,0,2407,184,4624,12,114,318,162,1529,1432,97
36047024000,3024000,5165,5025,140,68,2219,204,4348,36,136,286,155,1474,1396,78
36047024100,3024100,3175,3163,12,0,693,485,1702,460,254,120,154,1451,1315,136
36047024200,3024200,3289,3149,140,0,1393,216,2401,24,116,465,67,922,792,130
36047024300,3024300,4347,4347,0,0,587,694,1532,1587,214,59,261,2120,1957,163
36047024400,3024400,3651,3641,10,0,1467,453,2540,32,427,147,52,1015,945,70
36047024500,3024500,4257,4257,0,0,636,391,1218,1926,421,50,251,1999,1829,170
36047024600,3024600,3436,3416,20,0,1029,345,1924,37,1036,39,55,1099,1014,85
36047024700,3024700,2820,2607,213,0,491,298,644,1461,248,46,123,1256,1154,102
36047024800,3024800,2647,2647,0,0,634,443,1093,29,988,34,60,920,854,66
36047024900,3024900,4264,4238,26,0,649,443,1259,2100,170,37,255,2051,1880,171
36047025000,3025000,1748,1735,13,0,327,275,264,9,1179,9,12,588,530,58
36047025100,3025100,4209,4052,157,0,764,794,771,2156,237,49,202,1647,1539,108
36047025200,3025200,5300,5300,0,0,1076,941,1882,35,2324,22,96,1938,1869,69
36047025300,3025300,3517,3517,0,0,602,496,1296,1262,212,63,188,1631,1456,175
36047025400,3025400,3650,3650,0,0,783,431,1055,47,2012,38,67,1258,1189,69
36047025500,3025500,4799,4799,0,0,1151,2815,58,1721,89,31,85,1721,1708,13
36047025600,3025600,3366,3366,0,0,694,373,958,33,1906,30,66,1133,1082,51
36047025700,3025700,2822,2822,0,0,815,867,1227,434,139,53,102,917,870,47
36047025800,3025800,5073,5073,0,0,1149,864,1843,50,2155,16,145,1746,1687,59
36047025901,3025901,2328,2186,142,0,515,744,773,598,93,9,111,822,773,49
36047025902,3025902,3560,3560,0,0,1034,1707,52,1593,72,48,88,1163,1140,23
36047026000,3026000,3656,3656,0,0,697,650,1066,35,1839,22,44,1267,1210,57
36047026100,3026100,6479,6137,342,0,1059,1469,1787,2440,367,88,328,2826,2615,211
36047026200,3026200,2726,2726,0,0,567,453,623,12,1554,9,75,890,861,29
36047026300,3026300,2088,2073,15,0,348,389,454,1058,76,22,89,956,901,55
36047026400,3026400,5103,5103,0,0,1178,1282,1494,31,2193,36,67,1757,1651,106
36047026500,3026500,4385,4322,63,0,771,714,994,2228,170,70,209,1849,1700,149
36047026600,3026600,3961,3961,0,0,783,565,1201,47,2066,20,62,1342,1276,66
36047026700,3026700,4228,4090,138,129,496,389,1197,2075,213,52,302,2014,1804,210
36047026800,3026800,4686,4650,36,0,1023,843,1779,75,1854,22,113,1611,1526,85
36047026900,3026900,3005,3005,0,0,420,298,689,1568,223,30,197,1409,1303,106
36047027000,3027000,2719,2719,0,0,560,231,1309,19,1067,15,78,1000,951,49
36047027100,3027100,3493,3487,6,0,659,423,488,2082,309,37,154,1541,1404,137
36047027200,3027200,3633,3633,0,0,861,619,1363,31,1513,11,96,1269,1213,56
36047027300,3027300,3131,3125,6,0,494,260,574,1998,98,49,152,1396,1310,86
36047027400,3027400,3272,3269,3,0,725,482,1172,53,1473,8,84,1109,1011,98
36047027500,3027500,4071,4046,25,0,583,383,1107,2118,162,58,243,1875,1716,159
36047027600,3027600,3886,3886,0,0,893,895,1140,63,1672,15,101,1332,1257,75
36047027700,3027700,4351,4340,11,0,973,671,543,2820,74,33,210,1794,1662,132
36047027800,3027800,3542,3538,4,0,779,474,1459,46,1423,32,108,1276,1232,44
36047027900,3027900,3674,3665,9,0,597,501,714,2135,97,39,188,1734,1510,224
36047028000,3028000,1862,1847,15,0,369,379,584,52,784,21,42,705,659,46
36047028100,3028100,4800,4714,86,0,890,1674,718,1922,246,49,191,1983,1848,135
36047028200,3028200,3282,3280,2,0,700,349,1452,36,1274,20,151,1338,1238,100
36047028300,3028300,3933,3710,223,34,847,1369,474,1764,137,58,131,1502,1427,75
36047028400,3028400,4396,4388,8,0,973,973,1706,53,1503,11,150,1524,1455,69
36047028501,3028501,636,529,107,44,64,263,202,104,40,3,24,233,218,15
36047028502,3028502,2658,2658,0,0,585,1312,13,1227,33,10,63,1107,1083,24
36047028600,3028600,6094,6094,0,0,1713,610,2358,124,2640,41,321,2135,2036,99
36047028700,3028700,3103,3093,10,0,526,1036,603,1037,265,38,124,1348,1229,119
36047028800,3028800,3900,3900,0,0,786,734,1486,23,1561,29,67,1336,1298,38
36047028900,3028900,3933,3632,301,0,706,1078,764,1672,173,50,196,1585,1460,125
36047029000,3029000,4377,4361,16,0,1024,662,2103,83,1238,54,237,1622,1562,60
36047029100,3029100,3042,2967,75,0,433,472,641,1627,98,43,161,1485,1301,184
36047029200,3029200,2781,2781,0,0,573,505,1086,35,999,21,135,1051,1005,46
36047029300,3029300,3402,3400,2,0,603,598,530,2027,79,39,129,1547,1426,121
36047029400,3029400,2298,1675,623,456,356,229,1180,97,656,6,130,641,621,20
36047029500,3029500,3851,3851,0,0,517,375,932,2128,129,37,250,1900,1694,206
36047029600,3029600,5993,5986,7,0,1249,679,2936,64,2064,31,219,2301,2185,116
36047029700,3029700,3921,3909,12,0,739,339,693,2560,102,39,188,1795,1610,185
36047029800,3029800,3955,3955,0,0,857,838,1446,42,1487,4,138,1376,1320,56
36047029900,3029900,2496,2275,221,190,524,601,270,1375,135,23,92,889,842,47
36047030000,3030000,4224,4224,0,0,893,568,1192,23,2320,13,108,1479,1405,74
36047030100,3030100,2970,2941,29,0,550,420,287,1994,58,50,161,1230,1116,114
36047030200,3030200,4391,4391,0,0,887,388,1324,58,2522,18,81,1604,1507,97
36047030300,3030300,4952,4728,224,22,1234,817,158,3600,96,55,226,1988,1876,112
36047030400,3030400,4686,4673,13,0,987,593,1627,105,2158,26,177,1755,1687,68
36047030500,3030500,7249,6966,283,283,988,1104,2916,2160,577,92,400,3299,3190,109
36047030600,3030600,2215,2194,21,12,451,412,695,40,1019,16,33,804,729,75
36047030700,3030700,5625,5625,0,0,1359,1119,302,3721,127,93,263,2543,2359,184
36047030800,3030800,2314,2203,111,0,408,316,1137,127,678,14,42,899,832,67
36047030900,3030900,2209,2184,25,0,524,417,168,1390,111,22,101,941,856,85
36047031100,3031100,3191,3144,47,0,488,411,590,1743,154,53,240,1411,1239,172
36047031300,3031300,5109,4803,306,0,695,615,966,3030,119,66,313,2481,2266,215
36047031401,3031401,5142,5129,13,0,899,660,2819,69,1486,28,80,2168,2063,105
36047031402,3031402,0,0,0,0,0,0,0,0,0,0,0,0,0,0
36047031500,3031500,5613,5508,105,0,679,560,1881,2490,298,57,327,2813,2609,204
36047031701,3031701,3999,3999,0,0,519,349,1289,1804,238,55,264,1810,1703,107
36047031702,3031702,3714,3713,1,0,486,465,1400,1348,180,42,279,1798,1651,147
36047031900,3031900,3452,3433,19,0,746,270,1153,1664,85,87,193,1424,1330,94
36047032100,3032100,5488,5194,294,7,1003,909,979,3094,180,66,260,2296,2186,110
36047032300,3032300,3509,3509,0,0,495,504,686,1957,93,39,230,1532,1469,63
36047032500,3032500,6218,6195,23,0,1087,525,799,4459,113,56,266,2562,2451,111
36047032600,3032600,7075,6829,246,20,1822,2197,883,2654,1058,74,209,2514,2398,116
36047032700,3032700,3074,3051,23,0,407,364,805,1567,140,25,173,1511,1416,95
36047032800,3032800,3090,3070,20,13,638,612,288,1034,1081,12,63,1097,1064,33
36047032900,3032900,5707,5707,0,0,1169,721,1848,2564,98,198,278,2412,2299,113
36047033000,3033000,4423,4423,0,0,1164,1192,775,1946,299,51,160,1773,1712,61
36047033100,3033100,4217,4211,6,0,1185,178,2476,1217,10,186,150,1531,1467,64
36047033300,3033300,4503,4492,11,0,1394,208,3002,949,32,181,131,1441,1379,62
36047033500,3033500,3231,2967,264,0,824,195,1840,813,67,197,119,978,909,69
36047033600,3033600,4765,4631,134,0,956,464,3480,267,327,106,121,1997,1759,238
36047033701,3033701,2510,2466,44,0,601,177,1088,991,54,71,129,898,839,59
36047033702,3033702,2116,2000,116,25,598,136,1152,562,16,175,75,689,630,59
36047033900,3033900,4676,4649,27,0,882,454,1102,2586,181,88,265,2088,1917,171
36047034000,3034000,1958,1414,544,423,299,509,614,716,72,3,44,672,647,25
36047034100,3034100,2685,2431,254,229,319,268,638,1543,55,35,146,1106,1030,76
36047034200,3034200,7060,6883,177,177,1548,1615,1933,2689,516,90,217,3188,3078,110
36047034300,3034300,5024,5001,23,0,1193,1007,446,3131,133,49,258,2161,2027,134
36047034500,3034500,2738,2730,8,8,495,355,374,1725,65,52,167,1188,1042,146
36047034700,3034700,3645,3571,74,0,742,483,257,2628,56,48,173,1619,1516,103
36047034800,3034800,2828,2824,4,0,800,1324,664,186,517,30,107,914,849,65
36047034901,3034901,2067,2058,9,0,473,311,99,1470,23,45,119,808,764,44
36047034902,3034902,3347,3347,0,0,597,405,322,2332,65,34,189,1399,1317,82
36047035000,3035000,3082,3082,0,0,291,42,2932,21,32,7,48,1577,1518,59
36047035101,3035101,2243,2237,6,0,443,331,244,1409,75,27,157,939,892,47
36047035102,3035102,2626,2597,29,0,668,312,884,1146,35,104,145,948,889,59
36047035200,3035200,1367,956,411,243,99,251,637,331,90,11,47,664,647,17
36047035301,3035301,2566,2489,77,0,418,311,389,1645,39,40,142,1116,1052,64
36047035302,3035302,2811,2791,20,18,685,427,932,1234,63,60,95,1043,956,87
36047035400,3035400,5493,5493,0,0,678,135,5073,102,61,16,106,2946,2844,102
36047035500,3035500,5192,5167,25,0,1139,494,1029,3303,40,104,222,2054,1954,100
36047035601,3035601,2902,2902,0,0,300,92,2650,94,1,13,52,1552,1528,24
36047035602,3035602,5474,5462,12,0,678,155,4882,104,139,47,147,2973,2865,108
36047035701,3035701,2322,2322,0,0,528,441,80,1605,65,22,109,951,924,27
36047035702,3035702,15,0,15,0,2,7,3,3,0,2,0,0,0,0
36047035900,3035900,5617,5371,246,0,1324,876,253,4085,47,76,280,2224,2130,94
36047036001,3036001,3387,3354,33,0,409,116,2882,25,201,20,143,1863,1774,89
36047036002,3036002,4203,4186,17,1,480,191,3431,28,353,23,177,2239,2171,68
36047036100,3036100,2964,2696,268,0,659,592,137,2014,41,18,162,1167,1101,66
36047036200,3036200,4140,4089,51,0,921,1159,1721,128,952,23,157,1528,1418,110
36047036300,3036300,5385,5369,16,0,1453,1025,124,3808,46,82,300,2127,2024,103
36047036400,3036400,3006,2981,25,0,662,585,1383,55,830,33,120,1070,1004,66
36047036501,3036501,2959,2957,2,0,565,354,94,2287,52,21,151,1297,1241,56
36047036502,3036502,1902,1454,448,0,390,552,113,1118,23,25,71,626,560,66
36047036600,3036600,4681,4396,285,285,1013,1053,1889,61,1481,30,167,1618,1504,114
36047036700,3036700,1796,1504,292,0,414,655,107,880,49,33,72,566,516,50
36047036900,3036900,6136,6075,61,0,1220,1613,672,3323,159,83,286,2470,2278,192
36047037000,3037000,4750,4396,354,354,909,507,2881,154,1080,49,79,1735,1622,113
36047037100,3037100,4503,4503,0,0,830,698,403,3021,114,45,222,1813,1660,153
36047037300,3037300,4385,4356,29,0,792,988,502,2522,103,42,228,2020,1863,157
36047037401,3037401,4696,4696,0,0,986,397,3105,160,786,67,181,2007,1890,117
36047037402,3037402,5367,5367,0,0,978,517,3214,219,1146,24,247,2316,2243,73
36047037500,3037500,3809,3765,44,0,533,862,772,1684,224,35,232,1678,1553,125
36047037700,3037700,3970,3858,112,0,573,433,783,2371,80,44,259,1732,1560,172
36047037900,3037900,3851,3851,0,0,674,493,435,2562,71,52,238,1653,1551,102
36047038100,3038100,5313,5313,0,0,1084,842,660,3428,131,40,212,2199,2074,125
36047038200,3038200,5882,5867,15,0,1293,1817,336,1797,1754,44,134,2170,2125,45
36047038300,3038300,4338,4310,28,0,699,433,866,2548,133,63,295,1928,1743,185
36047038500,3038500,3969,3792,177,0,600,660,793,2082,150,67,217,1775,1615,160
36047038600,3038600,3812,3806,6,0,827,775,1383,28,1487,20,119,1300,1209,91
36047038700,3038700,4908,4727,181,0,760,922,1012,2313,345,58,258,2104,1904,200
36047038800,3038800,4047,4046,1,0,1054,461,2714,98,597,51,126,1534,1399,135
36047038900,3038900,3570,3340,230,0,500,1614,1041,452,284,57,122,1488,1379,109
36047039000,3039000,2321,2321,0,0,695,147,1960,7,157,26,24,878,764,114
36047039100,3039100,5776,5688,88,0,694,2376,2003,560,502,62,273,3008,2703,305
36047039200,3039200,2908,2908,0,0,758,310,2214,33,253,25,73,1105,1028,77
36047039300,3039300,4141,4117,24,0,541,1746,1251,655,273,56,160,1821,1707,114
36047039400,3039400,2187,2187,0,0,637,195,1738,10,144,48,52,782,705,77
36047039500,3039500,4030,3939,91,0,537,1617,1136,771,292,77,137,1725,1575,150
36047039600,3039600,1948,1948,0,0,501,169,1580,35,112,14,38,785,695,90
36047039700,3039700,3868,3847,21,0,540,1193,950,1326,176,48,175,1763,1602,161
36047039800,3039800,2841,2841,0,0,613,522,957,25,1278,15,44,1013,951,62
36047039900,3039900,4378,3790,588,0,725,1804,837,1342,180,50,165,1532,1416,116
36047040000,3040000,3281,3269,12,0,723,621,1235,49,1298,12,66,1202,1130,72
36047040100,3040100,3778,3557,221,0,668,1341,781,1209,171,94,182,1510,1377,133
36047040200,3040200,3025,3025,0,0,576,492,735,22,1710,12,54,1050,980,70
36047040300,3040300,3892,3842,50,0,625,1272,727,1502,162,69,160,1612,1447,165
36047040400,3040400,2812,2812,0,0,509,320,885,33,1491,14,69,1006,932,74
36047040500,3040500,1829,1812,17,0,361,744,298,602,94,24,67,732,683,49
36047040600,3040600,3599,3599,0,0,734,448,1044,17,2009,18,63,1299,1223,76
36047040700,3040700,6,6,0,0,3,2,1,0,0,0,3,1,0,1
36047040800,3040800,3933,3933,0,0,763,770,924,28,2120,36,55,1303,1208,95
36047040900,3040900,3800,3800,0,0,720,2311,617,588,130,31,123,1420,1343,77
36047041000,3041000,2136,2112,24,0,447,292,1055,39,701,20,29,802,759,43
36047041100,3041100,3332,3319,13,0,561,1484,571,980,131,31,135,1283,1178,105
36047041200,3041200,3375,3375,0,0,784,543,1354,53,1351,17,57,1187,1137,50
36047041300,3041300,3951,3951,0,0,754,1720,672,1203,136,49,171,1446,1349,97
36047041401,3041401,1480,1480,0,0,437,171,1106,19,147,3,34,524,490,34
36047041402,3041402,1855,1855,0,0,462,86,1480,24,137,12,116,755,717,38
36047041500,3041500,4032,4032,0,0,740,2019,697,965,151,44,156,1464,1316,148
36047041600,3041600,2112,2112,0,0,628,134,1720,74,100,42,42,751,703,48
36047041700,3041700,3348,3336,12,0,637,2114,352,650,152,20,60,1401,1319,82
36047041800,3041800,2645,2507,138,0,734,310,1921,35,260,32,87,932,890,42
36047041900,3041900,3880,3880,0,0,740,2334,601,639,151,37,118,1413,1333,80
36047042000,3042000,1912,1912,0,0,629,207,1516,36,45,46,62,572,537,35
36047042100,3042100,4866,4700,166,0,793,2574,1238,537,351,41,125,1816,1723,93
36047042200,3042200,3663,3637,26,0,1055,587,2408,71,417,39,141,1231,1142,89
36047042300,3042300,4566,4321,245,222,653,2554,1291,251,259,31,180,1686,1597,89
36047042400,3042400,4175,4160,15,7,917,680,1588,96,1613,19,179,1515,1459,56
36047042500,3042500,3026,3012,14,14,449,1731,845,192,115,38,105,1144,1095,49
36047042600,3042600,4350,4350,0,0,863,769,1531,26,1862,16,146,1653,1493,160
36047042700,3042700,4920,4920,0,0,753,2658,1523,240,268,81,150,1925,1822,103
36047042800,3042800,4290,4133,157,0,807,349,2275,89,1355,25,197,1581,1532,49
36047042900,3042900,5556,5556,0,0,1039,3282,1498,170,361,68,177,2062,1965,97
36047043000,3043000,3842,3842,0,0,835,552,1583,41,1483,19,164,1402,1361,41
36047043100,3043100,4884,4866,18,0,846,2750,1449,165,290,60,170,1864,1779,85
36047043200,3043200,4514,4507,7,0,942,1010,1391,53,1897,29,134,1629,1557,72
36047043300,3043300,3843,3814,29,0,705,2487,584,399,246,47,80,1455,1377,78
36047043400,3043400,3866,3866,0,0,787,522,1616,44,1528,22,134,1428,1363,65
36047043500,3043500,4709,4693,16,0,914,2801,812,632,256,63,145,1635,1539,96
36047043600,3043600,4694,4677,17,0,1033,955,1948,42,1504,20,225,1696,1640,56
36047043700,3043700,5282,5226,56,0,902,2791,1149,883,183,95,181,1952,1798,154
36047043800,3043800,2905,2905,0,0,828,255,1910,75,467,23,175,1026,994,32
36047043900,3043900,4097,4042,55,0,738,2530,654,418,333,43,119,1441,1339,102
36047044000,3044000,2878,2869,9,0,894,380,2100,29,266,36,67,974,896,78
36047044100,3044100,5526,5522,4,4,1031,3607,1015,190,504,84,126,2025,1924,101
36047044200,3044200,2631,2601,30,0,830,178,2316,20,52,23,42,913,839,74
36047044300,3044300,5195,5195,0,0,905,2931,1385,174,502,72,131,2070,1904,166
36047044400,3044400,3260,3257,3,0,966,304,2531,64,252,45,64,1256,1158,98
36047044500,3044500,4207,4207,0,0,746,2160,1100,111,624,78,134,1689,1593,96
36047044600,3044600,2026,1999,27,0,434,427,802,25,723,3,46,728,680,48
36047044700,3044700,2459,2087,372,0,528,1080,805,357,125,34,58,909,854,55
36047044800,3044800,1965,1965,0,0,515,156,1454,42,207,40,66,841,774,67
36047044901,3044901,2694,2645,49,0,597,1113,518,865,77,30,91,1134,1088,46
36047044902,3044902,44,44,0,0,6,16,20,2,0,0,6,22,15,7
36047045000,3045000,645,641,4,0,243,51,561,8,13,8,4,186,177,9
36047045200,3045200,2618,2613,5,0,853,76,2327,54,79,28,54,942,863,79
36047045300,3045300,1886,1721,165,0,200,694,827,180,74,32,79,786,734,52
36047045400,3045400,2036,2017,19,0,666,178,1587,24,149,44,54,630,576,54
36047045600,3045600,2767,2577,190,0,717,220,1481,140,738,15,173,891,848,43
36047045800,3045800,1558,1558,0,0,435,28,1421,5,49,29,26,556,537,19
36047046000,3046000,3828,3816,12,0,953,413,1586,180,1402,66,181,1318,1272,46
36047046201,3046201,2700,2691,9,0,716,238,1693,70,503,38,158,1134,1073,61
36047046202,3046202,1891,1891,0,0,677,227,1349,37,134,37,107,603,555,48
36047046400,3046400,2732,2730,2,0,1195,171,2263,31,108,97,62,691,649,42
36047046800,3046800,2138,2131,7,0,1031,58,1908,9,52,80,31,527,481,46
36047047000,3047000,2823,2820,3,0,1185,60,2420,13,68,180,82,811,746,65
36047047200,3047200,3099,3015,84,84,1361,58,2805,16,20,150,50,782,715,67
36047047400,3047400,3232,3232,0,0,1389,60,2771,12,137,131,121,900,843,57
36047047600,3047600,4054,4050,4,0,1774,173,3533,20,113,120,95,1138,1063,75
36047047700,3047700,4226,4115,111,0,405,660,2821,158,363,33,191,2172,2003,169
36047047800,3047800,5308,5236,72,0,2073,871,3428,81,483,256,189,1401,1284,117
36047048000,3048000,3824,3798,26,0,1361,613,2154,152,630,81,194,1152,1106,46
36047048100,3048100,3105,3083,22,0,267,847,1658,81,310,47,162,1641,1556,85
36047048200,3048200,6122,5999,123,0,1517,684,2378,429,2133,117,381,2235,2142,93
36047048400,3048400,5922,5904,18,14,1884,822,3306,250,1101,114,329,1845,1739,106
36047048500,3048500,2470,2323,147,0,221,736,1209,212,161,50,102,1054,956,98
36047048600,3048600,3597,3597,0,0,989,775,711,113,1876,50,72,991,956,35
36047048800,3048800,4536,4494,42,0,1193,668,1931,261,1382,115,179,1520,1454,66
36047048900,3048900,3757,3757,0,0,926,2176,62,1401,32,19,67,1447,1416,31
36047049000,3049000,6036,6005,31,10,1505,829,2569,448,1679,84,427,2307,2204,103
36047049100,3049100,6366,6366,0,0,976,2157,1338,812,1885,50,124,2766,2669,97
36047049200,3049200,3366,3243,123,0,776,658,1110,413,941,66,178,1163,1101,62
36047049301,3049301,1897,1897,0,0,387,1260,53,495,45,18,26,973,918,55
36047049302,3049302,5476,5471,5,0,801,2878,1515,580,280,55,168,2370,2242,128
36047049400,3049400,5527,5314,213,195,1082,743,2488,615,1299,75,307,2162,2070,92
36047049500,3049500,3114,3114,0,0,316,762,1739,122,302,37,152,1522,1427,95
36047049600,3049600,4646,4511,135,0,1085,968,1625,220,1685,33,115,1554,1479,75
36047049700,3049700,3141,3130,11,0,337,359,2253,97,271,23,138,1768,1651,117
36047049800,3049800,4517,4512,5,0,989,730,1818,136,1642,35,156,1686,1598,88
36047049900,3049900,2147,2141,6,0,260,268,1512,36,193,24,114,1080,1010,70
36047050001,3050001,2062,2002,60,0,447,272,1248,153,237,27,125,936,882,54
36047050002,3050002,1607,1607,0,0,359,251,941,91,217,12,95,694,660,34
36047050100,3050100,2951,2951,0,0,274,530,1964,37,250,26,144,1625,1504,121
36047050202,3050202,2312,2275,37,0,487,226,1700,75,138,26,147,1084,1025,59
36047050300,3050300,2759,2759,0,0,251,634,1680,56,237,34,118,1414,1319,95
36047050401,3050401,2997,2989,8,0,638,395,1879,213,286,24,200,1335,1279,56
36047050402,3050402,2004,1987,17,0,363,381,871,206,402,34,110,882,849,33
36047050500,3050500,4567,4490,77,0,598,1816,1222,700,648,31,150,2146,2024,122
36047050600,3050600,5612,5488,124,111,1098,1895,1010,1873,502,77,255,1999,1930,69
36047050700,3050700,3545,3539,6,0,1815,559,2625,142,35,97,87,785,742,43
36047050801,3050801,4311,4287,24,0,845,1011,460,2410,148,52,230,1557,1496,61
36047050803,3050803,2548,2390,158,0,384,470,515,1261,120,44,138,1044,1013,31
36047050804,3050804,6196,6196,0,0,1004,1666,1358,2422,344,84,322,2711,2614,97
36047050900,3050900,5112,5102,10,0,2646,308,4435,38,77,160,94,1126,1072,54
36047051001,3051001,3740,3740,0,0,615,664,469,2319,66,44,178,1440,1409,31
36047051002,3051002,4600,4577,23,0,775,970,593,2536,206,46,249,1890,1814,76
36047051100,3051100,4545,4500,45,0,543,1684,1484,312,882,41,142,2058,1983,75
36047051200,3051200,5946,5946,0,0,1052,1451,896,3027,257,62,253,2385,2325,60
36047051300,3051300,5526,5447,79,0,493,1738,2711,278,486,44,269,2887,2594,293
36047051400,3051400,7023,6989,34,0,1182,1887,1275,2825,682,61,293,2759,2677,82
36047051500,3051500,2451,2444,7,0,288,362,1658,84,208,16,123,1331,1263,68
36047051601,3051601,5407,5190,217,95,1182,963,599,3244,242,75,284,1952,1899,53
36047051602,3051602,3874,3742,132,132,731,741,349,2374,121,72,217,1365,1320,45
36047051700,3051700,2636,2636,0,0,251,309,1841,60,259,37,130,1592,1456,136
36047051800,3051800,3528,3499,29,0,646,470,1045,1369,420,43,181,1488,1411,77
36047051900,3051900,6101,6070,31,0,542,822,4131,114,676,50,308,3518,3201,317
36047052000,3052000,4175,4148,27,0,889,873,1175,618,1279,55,175,1457,1407,50
36047052300,3052300,5405,5383,22,0,653,2875,1860,172,321,36,141,2490,2390,100
36047052500,3052500,3720,3720,0,0,1129,952,2050,301,161,135,121,1425,1344,81
36047052600,3052600,4353,4329,24,0,876,808,1515,717,1012,54,247,1743,1678,65
36047052700,3052700,6045,6026,19,7,889,3640,1745,166,272,51,171,2603,2411,192
36047052800,3052800,1804,1804,0,0,380,160,869,141,501,42,91,700,646,54
36047052900,3052900,4299,4205,94,0,1867,254,3839,31,33,81,61,1178,1085,93
36047053000,3053000,3606,3518,88,0,950,444,1808,227,915,50,162,1207,1155,52
36047053101,3053101,2997,2997,0,0,1598,116,2638,7,55,125,56,685,652,33
36047053102,3053102,5890,5890,0,0,3428,169,5320,19,46,219,117,1106,1067,39
36047053200,3053200,2510,2504,6,0,552,293,1333,204,548,62,70,1026,933,93
36047053300,3053300,7115,7097,18,0,3397,175,6540,17,6,223,154,1954,1797,157
36047053400,3053400,4777,4616,161,161,1472,400,2523,342,1237,63,212,1425,1345,80
36047053500,3053500,4469,4396,73,0,1903,289,3889,37,31,142,81,1309,1200,109
36047053700,3053700,4304,4107,197,197,2214,80,3912,46,39,121,106,877,840,37
36047053800,3053800,5535,5519,16,6,1287,474,3671,256,832,83,219,2318,2220,98
36047053900,3053900,2668,2668,0,0,990,366,2114,85,8,50,45,840,828,12
36047054200,3054200,4750,4721,29,0,1251,461,3559,76,408,98,148,1715,1622,93
36047054300,3054300,5,5,0,0,2,4,1,0,0,0,0,2,0,2
36047054400,3054400,3785,3785,0,0,1004,199,2759,43,591,72,121,1359,1289,70
36047054500,3054500,7304,7304,0,0,2673,1819,4402,795,33,111,144,2391,2320,71
36047054600,3054600,5409,5393,16,13,1255,383,3516,207,887,56,360,2213,2119,94
36047054700,3054700,7855,7845,10,0,2763,1097,5764,289,363,129,213,3102,2626,476
36047054800,3054800,2189,2167,22,0,588,91,1870,20,86,25,97,788,752,36
36047054900,3054900,4748,4748,0,0,1094,772,3225,163,302,87,199,2276,2081,195
36047055000,3055000,3956,3950,6,0,914,399,2699,120,477,44,217,1611,1542,69
36047055100,3055100,6343,6301,42,0,743,2232,3163,251,381,61,255,3555,3196,359
36047055200,3055200,3735,3708,27,0,721,286,2266,109,827,28,219,1524,1465,59
36047055300,3055300,3078,2878,200,0,314,588,1895,168,266,24,137,1656,1486,170
36047055400,3055400,4813,4813,0,0,1150,597,2780,75,999,46,316,1868,1771,97
36047055500,3055500,8688,8677,11,0,1231,1400,5321,263,1141,78,485,4922,4516,406
36047055600,3055600,3880,3855,25,0,1020,305,2853,27,506,34,155,1418,1356,62
36047055700,3055700,1848,1848,0,0,181,225,1345,31,138,14,95,1087,978,109
36047055800,3055800,2736,2736,0,0,686,216,1772,25,569,28,126,989,954,35
36047056000,3056000,3882,3858,24,0,869,161,3028,59,427,8,199,1662,1537,125
36047056100,3056100,3460,3402,58,0,363,428,2632,64,165,30,141,1785,1643,142
36047056200,3056200,1695,1695,0,0,509,48,1458,13,141,11,24,589,511,78
36047056301,3056301,4923,4752,171,0,485,1064,2982,196,381,69,231,2650,2384,266
36047056302,3056302,2002,1987,15,0,500,614,845,282,155,22,84,1117,942,175
36047056400,3056400,2626,2626,0,0,552,157,1815,67,519,22,46,1087,1011,76
36047056500,3056500,3738,3685,53,0,407,567,2699,69,189,27,187,2017,1864,153
36047056600,3056600,2548,2546,2,0,489,194,1224,310,709,20,91,1049,990,59
36047056800,3056800,1310,1310,0,0,217,86,774,22,407,9,12,546,505,41
36047056900,3056900,1624,1624,0,0,159,191,1197,27,130,23,56,880,817,63
36047057000,3057000,3534,3350,184,184,499,379,1797,257,1015,18,68,1529,1454,75
36047057100,3057100,4267,4256,11,0,421,367,3468,42,219,16,155,2300,2126,174
36047057200,3057200,5221,5221,0,0,1332,1422,548,2585,422,53,191,2209,2174,35
36047057300,3057300,2590,2590,0,0,258,230,2061,49,135,23,92,1322,1218,104
36047057400,3057400,2560,2555,5,0,474,175,1039,57,1234,19,36,977,882,95
36047057500,3057500,4902,4862,40,16,469,901,3258,76,424,38,205,2622,2421,201
36047057600,3057600,2912,2912,0,0,572,203,1130,56,1408,13,102,1059,996,63
36047057800,3057800,3332,3332,0,0,689,374,1572,74,1143,46,123,1248,1134,114
36047057901,3057901,1416,1317,99,0,134,396,764,70,115,21,50,657,599,58
36047057902,3057902,0,0,0,0,0,0,0,0,0,0,0,0,0,0
36047058000,3058000,3502,3502,0,0,775,400,1449,95,1410,25,123,1302,1247,55
36047058200,3058200,3044,3044,0,0,788,309,1578,53,959,9,136,1114,1033,81
36047058400,3058400,3797,3781,16,0,802,262,2553,50,798,12,122,1553,1479,74
36047058600,3058600,2655,2648,7,0,527,207,738,106,1564,15,25,902,856,46
36047058800,3058800,3532,3517,15,0,636,295,2345,67,712,25,88,1566,1485,81
36047058901,3058901,1781,1781,0,0,242,117,1464,30,95,8,67,871,789,82
36047058902,3058902,0,0,0,0,0,0,0,0,0,0,0,0,0,0
36047059000,3059000,2014,2014,0,0,460,284,693,100,833,17,87,737,692,45
36047059100,3059100,3856,3856,0,0,504,494,2969,51,165,26,151,2017,1888,129
36047059200,3059200,4268,4268,0,0,800,298,2380,75,1229,14,272,1792,1727,65
36047059300,3059300,2274,2274,0,0,316,370,1645,33,111,12,103,1063,1002,61
36047059402,3059402,5105,5105,0,0,881,280,3212,49,1394,23,147,2088,2007,81
36047059403,3059403,3779,3779,0,0,714,211,1830,51,1544,15,128,1464,1394,70
36047059404,3059404,4426,4424,2,0,887,330,2421,58,1442,18,157,1718,1648,70
36047059600,3059600,2569,2569,0,0,403,128,2013,61,290,16,61,1191,1161,30
36047059800,3059800,3617,3599,18,0,814,221,2492,165,439,24,276,1483,1377,106
36047060000,3060000,6844,6836,8,0,1255,368,5226,88,866,32,264,3013,2820,193
36047060600,3060600,3178,3164,14,0,528,309,2075,112,583,7,92,1469,1394,75
36047060800,3060800,4015,3905,110,110,694,268,2811,149,621,6,160,1802,1714,88
36047061002,3061002,5064,5064,0,0,750,104,4669,29,127,37,98,2608,2475,133
36047061003,3061003,2418,2418,0,0,608,810,613,25,839,32,99,740,693,47
36047061004,3061004,6669,6669,0,0,1125,523,5059,78,679,49,281,3188,3059,129
36047061200,3061200,1063,1063,0,0,209,31,961,6,22,14,29,474,386,88
36047061600,3061600,1854,1466,388,388,309,58,1692,28,28,19,29,588,534,54
36047062000,3062000,1767,1767,0,0,368,41,1633,5,55,2,31,721,661,60
36047062200,3062200,3325,2910,415,133,588,257,2315,392,211,37,113,1566,1342,224
36047062600,3062600,3152,3141,11,1,668,339,1554,246,856,42,115,1207,1130,77
36047062800,3062800,5222,5215,7,0,1049,573,3862,44,620,27,96,2027,1855,172
36047063200,3063200,1476,1464,12,0,209,144,1073,38,171,8,42,727,681,46
36047063600,3063600,1317,1317,0,0,273,132,846,18,273,24,24,488,455,33
36047063800,3063800,1617,1606,11,0,311,122,1082,78,293,7,35,684,624,60
36047064000,3064000,1620,1620,0,0,473,117,1253,23,191,4,32,534,487,47
36047064200,3064200,2865,2703,162,142,635,305,2019,123,288,31,99,1068,1007,61
36047064400,3064400,2702,2660,42,0,836,278,1844,130,343,49,58,862,787,75
36047064600,3064600,2226,2216,10,0,705,165,1663,107,172,72,47,694,655,39
36047064800,3064800,1993,1986,7,0,544,233,1129,274,233,31,93,653,606,47
36047065000,3065000,1439,1423,16,0,276,239,335,544,254,7,60,518,484,34
36047065200,3065200,1197,1197,0,0,265,127,743,42,211,23,51,476,412,64
36047065400,3065400,1681,1681,0,0,479,145,1229,30,209,18,50,567,542,25
36047065600,3065600,1795,1795,0,0,432,170,1323,5,257,7,33,627,598,29
36047065800,3065800,1844,1844,0,0,399,205,1165,31,380,12,51,747,682,65
36047066000,3066000,1762,1762,0,0,377,165,1229,11,311,4,42,679,638,41
36047066200,3066200,1497,1490,7,0,303,201,849,62,345,8,32,609,551,58
36047066600,3066600,1,1,0,0,0,1,0,0,0,0,0,1,1,0
36047067000,3067000,2876,2876,0,0,601,388,466,1377,482,14,149,1084,994,90
36047067200,3067200,1435,1435,0,0,257,149,135,936,111,35,69,474,440,34
36047067400,3067400,1992,1984,8,0,401,203,241,1174,205,53,116,633,593,40
36047067600,3067600,1622,1622,0,0,287,141,133,1127,84,36,101,605,567,38
36047067800,3067800,2874,2872,2,0,595,195,259,2193,87,21,119,1041,959,82
36047068000,3068000,1887,1887,0,0,391,264,206,1141,149,19,108,609,581,28
36047068200,3068200,2489,2480,9,0,490,289,381,1362,253,34,170,889,826,63
36047068600,3068600,1749,1749,0,0,316,199,710,520,232,20,68,750,696,54
36047068800,3068800,1706,1698,8,0,269,233,383,853,136,16,85,622,607,15
36047069000,3069000,1880,1871,9,0,351,300,274,1077,119,26,84,639,610,29
36047069200,3069200,2512,2512,0,0,452,230,220,1812,107,33,110,899,851,48
36047069601,3069601,3932,3932,0,0,791,481,1131,1929,199,47,145,1632,1490,142
36047069602,3069602,6275,6258,17,4,1322,540,3578,1443,478,71,165,2355,2243,112
36047069800,3069800,1417,1347,70,70,270,134,1057,108,82,3,33,516,480,36
36047070000,3070000,1650,1635,15,0,328,153,1356,45,48,10,38,701,627,74
36047070201,3070201,6719,6705,14,0,1521,308,5918,72,247,64,110,2582,2393,189
36047070202,3070202,21,21,0,0,7,3,12,5,0,0,1,11,5,6
36047070203,3070203,0,0,0,0,0,0,0,0,0,0,0,0,0,0
36047070601,3070601,2703,2703,0,0,599,168,2342,44,69,18,62,1067,982,85
36047070602,3070602,4,4,0,0,0,0,2,0,0,0,2,3,3,0
36047072000,3072000,2205,2205,0,0,454,135,94,1806,74,19,77,721,697,24
36047072200,3072200,2893,2881,12,0,517,138,74,2341,103,30,207,1063,1002,61
36047072400,3072400,1911,1909,2,0,326,85,35,1672,21,16,82,727,694,33
36047072600,3072600,2582,2287,295,0,570,301,52,1950,79,43,157,749,725,24
36047072800,3072800,3645,3645,0,0,611,183,145,3006,64,38,209,1526,1469,57
36047073000,3073000,2170,2157,13,0,388,125,100,1711,90,32,112,746,716,30
36047073200,3073200,2173,2173,0,0,360,179,66,1604,114,39,171,736,704,32
36047073400,3073400,1818,1818,0,0,321,155,63,1332,112,31,125,592,547,45
36047073600,3073600,3473,3455,18,0,767,406,167,2205,462,73,160,1207,1158,49
36047073800,3073800,3290,3263,27,0,797,333,964,1534,266,54,139,1154,1079,75
36047074000,3074000,3446,3446,0,0,784,355,307,2131,392,72,189,1114,1056,58
36047074200,3074200,3023,3009,14,0,783,236,1269,1183,103,42,190,960,922,38
36047074400,3074400,2481,2470,11,0,918,63,2179,122,68,22,27,648,609,39
36047074600,3074600,2100,2064,36,0,579,156,1334,360,173,27,50,696,638,58
36047074800,3074800,1936,1936,0,0,539,112,1333,353,43,48,47,682,638,44
36047075000,3075000,2928,2899,29,0,859,136,2162,389,99,83,59,982,937,45
36047075200,3075200,1042,1042,0,0,310,12,961,12,12,4,41,334,309,25
36047075400,3075400,1402,1388,14,0,431,8,1343,13,0,15,23,470,442,28
36047075600,3075600,1934,1909,25,0,484,84,1560,69,136,34,51,698,665,33
36047075800,3075800,2005,2005,0,0,456,59,1654,39,144,22,87,775,739,36
36047076000,3076000,2832,2824,8,0,671,178,2139,49,324,26,116,1105,1073,32
36047076200,3076200,4391,4355,36,0,972,518,2127,423,1045,89,189,1661,1593,68
36047076400,3076400,3783,3762,21,0,727,644,941,1676,316,48,158,1494,1447,47
36047076600,3076600,1990,1989,1,0,350,258,236,1268,103,16,109,748,724,24
36047076800,3076800,4049,3861,188,0,1094,320,2687,131,673,77,161,1427,1280,147
36047077000,3077000,2776,2754,22,0,526,471,311,1637,111,65,181,1226,1025,201
36047077200,3077200,3070,3060,10,10,667,395,1007,1249,176,46,197,1185,1112,73
36047077400,3077400,3029,2998,31,0,707,396,545,1698,229,33,128,1156,1135,21
36047077600,3077600,3784,3784,0,0,650,337,209,2700,235,56,247,1716,1631,85
36047078000,3078000,2197,2169,28,0,320,149,54,1710,49,47,188,708,678,30
36047078200,3078200,4081,4081,0,0,797,267,65,3281,94,69,305,1581,1482,99
36047078400,3078400,2441,2441,0,0,404,218,137,1830,39,61,156,882,827,55
36047078601,3078601,2374,2374,0,0,479,315,90,1536,278,20,135,1004,928,76
36047078602,3078602,2073,2053,20,0,328,215,141,1536,53,41,87,913,850,63
36047078801,3078801,2040,2040,0,0,411,248,77,1449,82,16,168,775,728,47
36047078802,3078802,1328,1328,0,0,269,80,18,1097,9,13,111,490,477,13
36047079001,3079001,1347,1347,0,0,246,189,133,882,36,10,97,550,519,31
36047079002,3079002,3769,3762,7,0,715,338,181,2850,101,68,231,1422,1345,77
36047079201,3079201,1743,1743,0,0,348,269,128,1161,48,19,118,659,633,26
36047079202,3079202,3171,2351,820,0,1005,492,140,2241,120,26,152,939,859,80
36047079400,3079400,2742,2202,540,0,810,407,203,1888,36,59,149,806,752,54
36047079601,3079601,4125,4092,33,0,597,529,1010,2135,175,53,223,1965,1823,142
36047079602,3079602,4489,4489,0,0,701,700,711,2597,158,72,251,1977,1861,116
36047079801,3079801,2957,2957,0,0,421,289,836,1513,104,37,178,1346,1290,56
36047079802,3079802,5647,5647,0,0,802,680,1584,2652,310,87,334,2719,2623,96
36047080000,3080000,3562,3546,16,0,529,363,1019,1815,118,22,225,1512,1380,132
36047080200,3080200,4521,4521,0,0,737,536,802,2613,191,59,320,1999,1881,118
36047080400,3080400,3327,3310,17,0,524,283,661,1933,142,50,258,1487,1371,116
36047080600,3080600,3781,3742,39,0,1076,201,1442,1758,73,101,206,1327,1215,112
36047080800,3080800,1940,1106,834,790,240,445,179,1126,93,35,62,696,674,22
36047081000,3081000,2907,2452,455,455,552,187,520,1896,91,71,142,1033,941,92
36047081400,3081400,3121,3102,19,0,625,166,172,2422,114,80,167,1127,1052,75
36047081600,3081600,2580,2580,0,0,492,231,101,1989,87,55,117,983,916,67
36047081800,3081800,4830,4629,201,0,755,521,565,3160,201,53,330,2119,2011,108
36047082000,3082000,5495,5487,8,6,928,586,609,3708,155,62,375,2331,2212,119
36047082200,3082200,7201,7038,163,138,1108,850,866,4809,219,75,382,3446,3003,443
36047082400,3082400,4963,4942,21,0,949,535,303,3616,134,86,289,1960,1792,168
36047082600,3082600,5165,5146,19,0,953,421,256,3962,99,58,369,2082,1925,157
36047082800,3082800,4206,3912,294,265,810,470,211,3150,92,66,217,1528,1414,114
36047083000,3083000,6167,6082,85,0,1313,501,122,4875,112,90,467,2331,2220,111
36047083200,3083200,2362,2357,5,0,475,150,43,1836,119,45,169,765,738,27
36047083400,3083400,1733,1733,0,0,308,118,29,1373,55,25,133,597,562,35
36047083600,3083600,2160,2160,0,0,386,157,20,1763,85,17,118,810,752,58
36047083800,3083800,2226,2223,3,0,376,128,34,1756,42,30,236,830,760,70
36047084000,3084000,2324,2317,7,0,435,145,36,1928,24,44,147,784,759,25
36047084600,3084600,1986,1979,7,0,422,126,23,1604,26,44,163,747,686,61
36047084800,3084800,1728,1713,15,0,304,101,16,1353,69,36,153,599,565,34
36047085000,3085000,1509,1509,0,0,274,73,26,1263,16,14,117,508,469,39
36047085200,3085200,32,32,0,0,6,5,0,19,6,0,2,9,9,0
36047085400,3085400,1962,1962,0,0,316,155,64,1488,70,32,153,730,691,39
36047085600,3085600,3568,3568,0,0,693,330,138,2677,66,50,307,1489,1396,93
36047085800,3085800,2474,2474,0,0,462,137,42,1974,125,33,163,865,817,48
36047086000,3086000,3809,3784,25,0,786,374,39,3035,52,46,263,1342,1291,51
36047086200,3086200,3427,3427,0,0,739,242,39,2834,51,43,218,1230,1178,52
36047086400,3086400,2499,2499,0,0,473,148,45,2122,18,17,149,878,843,35
36047086600,3086600,3385,3380,5,0,641,216,135,2715,21,88,210,1340,1273,67
36047086800,3086800,3413,3390,23,0,685,199,86,2803,31,31,263,1349,1247,102
36047087000,3087000,3570,3558,12,0,678,208,99,2885,46,24,308,1312,1257,55
36047087200,3087200,3128,3128,0,0,641,125,132,2514,59,37,261,1171,1102,69
36047087401,3087401,3740,3740,0,0,920,311,619,2487,22,85,216,1515,1430,85
36047087600,3087600,2098,1959,139,0,477,171,538,1175,45,50,119,818,750,68
36047087800,3087800,2730,2639,91,15,458,183,78,2233,26,40,170,1041,980,61
36047088001,3088001,2127,1725,402,402,312,186,187,1625,8,45,76,769,727,42
36047088002,3088002,1374,1374,0,0,315,61,140,1036,22,17,98,543,488,55
36047088200,3088200,6804,6796,8,0,1542,606,175,5473,57,62,431,2750,2597,153
36047088400,3088400,5513,5488,25,0,1149,355,105,4580,41,127,305,2175,2017,158
36047088600,3088600,4547,4500,47,0,978,409,68,3715,22,35,298,1889,1787,102
36047088800,3088800,4001,4001,0,0,846,371,18,3305,16,44,247,1540,1472,68
36047089000,3089000,6683,5847,836,675,1263,653,150,5375,38,83,384,2402,2270,132
36047089200,3089200,3673,3533,140,0,752,519,70,2808,20,54,202,1580,1514,66
36047089400,3089400,3834,3673,161,0,992,445,43,3017,32,44,253,1353,1209,144
36047089600,3089600,4081,4065,16,0,920,412,71,3268,33,54,243,1704,1608,96
36047089800,3089800,2329,2329,0,0,591,310,36,1755,28,38,162,821,757,64
36047090000,3090000,5434,5430,4,0,1367,1139,49,3938,20,30,258,2045,1980,65
36047090200,3090200,3817,3136,681,0,1200,860,77,2620,73,54,133,1043,993,50
36047090600,3090600,4534,4509,25,0,1397,1521,62,2747,48,39,117,1627,1600,27
36047090800,3090800,5893,4228,1665,0,2241,1858,158,3579,39,61,198,1644,1583,61
36047091000,3091000,5814,5649,165,0,1460,1914,69,3516,100,50,165,2440,2404,36
36047091200,3091200,6572,6572,0,0,1897,2127,53,4077,60,59,196,2367,2338,29
36047091600,3091600,5309,5283,26,0,1380,837,62,3930,95,114,271,1941,1847,94
36047091800,3091800,2703,2698,5,0,631,1116,29,1421,15,25,97,1004,977,27
36047092000,3092000,3491,3481,10,0,880,529,29,2667,36,31,199,1226,1189,37
36047092200,3092200,3031,3031,0,0,571,262,19,2508,21,39,182,1372,1265,107
36047092400,3092400,3628,3396,232,59,1048,603,73,2693,17,50,192,1178,1132,46
36047092800,3092800,2861,2835,26,0,567,190,57,2330,22,42,220,1125,1051,74
36047093000,3093000,2567,2567,0,0,442,91,8,2311,6,49,102,1000,951,49
36047093200,3093200,1277,1277,0,0,215,56,13,1049,50,17,92,441,430,11
36047093400,3093400,2466,2466,0,0,399,126,40,2086,29,27,158,969,921,48
36047093600,3093600,1854,1854,0,0,357,91,4,1620,7,13,119,707,671,36
36047093800,3093800,2662,2412,250,0,517,263,67,2106,10,24,192,958,897,61
36047094401,3094401,3447,3447,0,0,610,128,58,3030,20,20,191,1263,1197,66
36047094402,3094402,2810,2810,0,0,650,458,66,2147,18,27,94,1193,1172,21
36047094600,3094600,2079,2073,6,0,361,103,25,1756,18,21,156,821,772,49
36047095000,3095000,3170,3170,0,0,629,142,111,2704,32,24,157,1076,1055,21
36047095400,3095400,5156,5156,0,0,999,219,100,4450,38,45,304,1728,1679,49
36047095600,3095600,4391,4391,0,0,888,252,168,3594,66,68,243,1469,1403,66
36047095800,3095800,3770,3759,11,0,739,220,119,3135,103,34,159,1330,1249,81
36047096000,3096000,6,6,0,0,4,1,0,3,0,0,2,3,3,0
36047096200,3096200,1701,1693,8,0,335,150,78,1336,27,14,96,573,548,25
36047096400,3096400,2621,2621,0,0,639,187,146,2005,76,24,183,863,815,48
36047096600,3096600,2353,2353,0,0,492,188,96,1793,72,44,160,810,763,47
36047096800,3096800,1555,1529,26,0,346,179,65,1160,31,22,98,494,471,23
36047097000,3097000,2357,2357,0,0,495,258,113,1795,47,25,119,839,794,45
36047097400,3097400,2911,2246,665,292,453,395,145,2170,36,45,120,796,769,27
36047098200,3098200,4076,4066,10,0,1029,1035,22,2822,9,43,145,1604,1576,28
36047098400,3098400,2074,2068,6,0,410,79,40,1862,5,17,71,686,653,33
36047098600,3098600,2814,2814,0,0,557,214,50,2238,66,49,197,1021,983,38
36047098800,3098800,3083,2816,267,267,527,334,90,2390,56,37,176,1070,1036,34
36047099000,3099000,1652,1652,0,0,361,132,63,1262,72,40,83,525,489,36
36047099200,3099200,2056,2051,5,0,411,150,108,1568,69,29,132,686,656,30
36047099400,3099400,2116,2116,0,0,467,97,96,1774,29,15,105,730,702,28
36047099600,3099600,4052,3971,81,0,856,200,197,3420,49,25,161,1269,1211,58
36047099800,3099800,4234,4234,0,0,768,156,148,3620,43,58,209,1464,1367,97
36047100400,3100400,2901,2901,0,0,564,122,51,2503,37,26,162,1048,999,49
36047100600,3100600,2662,2662,0,0,513,171,152,2149,47,22,121,929,884,45
36047100800,3100800,2189,2169,20,9,464,150,124,1694,73,17,131,756,722,34
36047101000,3101000,2605,2605,0,0,571,194,144,1932,126,26,183,840,796,44
36047101200,3101200,2115,2108,7,0,437,152,90,1632,76,52,113,801,746,55
36047101400,3101400,2268,2242,26,0,472,185,84,1771,98,29,101,828,804,24
36047101600,3101600,1551,1540,11,0,264,73,41,1323,31,14,69,495,471,24
36047101800,3101800,2030,2030,0,0,330,151,98,1661,22,18,80,799,771,28
36047102000,3102000,2186,2171,15,0,426,128,111,1740,65,15,127,683,664,19
36047102200,3102200,2313,2313,0,0,494,173,131,1750,136,30,93,831,792,39
36047102400,3102400,2257,2249,8,0,470,155,131,1691,98,46,136,742,713,29
36047102600,3102600,2973,2973,0,0,608,140,120,2521,33,26,133,998,961,37
36047102801,3102801,1754,1732,22,0,334,122,53,1397,60,28,94,618,583,35
36047102802,3102802,5,5,0,0,3,1,0,0,0,0,4,3,3,0
36047103401,3103401,3980,3980,0,0,1097,929,156,2711,13,25,146,1616,1596,20
36047103402,3103402,0,0,0,0,0,0,0,0,0,0,0,0,0,0
36047105801,3105801,7013,6941,72,28,1202,1278,1387,3760,259,60,269,3545,3492,53
36047105804,3105804,6482,6285,197,174,1092,1257,1152,3639,132,64,238,3272,3181,91
36047107001,3107001,3543,3543,0,0,1064,809,56,2474,33,39,132,1434,1350,84
36047107002,3107002,0,0,0,0,0,0,0,0,0,0,0,0,0,0
36047107003,3107003,0,0,0,0,0,0,0,0,0,0,0,0,0,0
36047107800,3107800,4112,4059,53,38,610,527,64,3316,22,26,157,1876,1794,82
36047109800,3109800,2290,1979,311,0,594,411,47,1615,30,38,149,681,633,48
36047110400,3110400,5068,4854,214,0,1168,863,87,3723,41,65,289,1952,1815,137
36047110600,3110600,4558,4558,0,0,1271,1180,46,3152,17,47,116,1902,1794,108
36047111000,3111000,3037,3037,0,0,724,716,24,2155,10,33,99,1429,1367,62
36047111600,3111600,3434,3259,175,175,798,778,56,2307,41,39,213,1149,1071,78
36047111800,3111800,3507,3477,30,0,941,938,98,2095,158,49,169,1244,1135,109
36047112000,3112000,3480,3461,19,0,833,1130,52,2001,94,24,179,1260,1140,120
36047112200,3112200,3514,3413,101,0,859,696,81,2332,63,62,280,1305,1211,94
36047112400,3112400,4288,4177,111,0,1079,895,92,3021,43,35,202,1501,1389,112
36047112600,3112600,4368,4274,94,0,1078,1105,56,2945,15,49,198,1671,1559,112
36047112800,3112800,4461,4458,3,0,1039,871,173,3059,32,70,256,1728,1585,143
36047113000,3113000,4460,4460,0,0,1092,952,79,3075,32,37,285,1707,1640,67
36047113200,3113200,2427,2389,38,0,524,455,28,1734,38,32,140,982,914,68
36047113400,3113400,2658,2539,119,0,749,912,59,1565,12,36,74,968,921,47
36047114201,3114201,1880,1880,0,0,404,1187,86,407,107,12,81,614,592,22
36047114202,3114202,2670,2647,23,0,558,1518,128,802,86,44,92,969,908,61
36047114400,3114400,2414,2283,131,0,600,996,72,1181,33,29,103,830,778,52
36047114600,3114600,3134,3079,55,0,722,2012,74,697,157,59,135,1027,958,69
36047115000,3115000,3123,3123,0,0,783,1452,59,1380,42,67,123,1016,954,62
36047115200,3115200,3496,3482,14,0,968,1202,80,1825,140,49,200,1161,1086,75
36047115600,3115600,4452,4400,52,18,1213,1642,110,2418,55,63,164,1631,1563,68
36047115800,3115800,3260,3211,49,0,771,886,60,1975,81,45,213,1165,1083,82
36047116000,3116000,2630,2579,51,0,654,814,12,1641,14,22,127,935,892,43
36047116200,3116200,2374,2374,0,0,512,497,41,1545,63,36,192,885,812,73
36047116400,3116400,3275,3260,15,0,756,1013,52,1836,148,53,173,1103,1062,41
36047116600,3116600,3484,3478,6,0,986,1529,60,1306,289,87,213,1162,1071,91
36047116800,3116800,2273,2251,22,0,540,1370,58,524,136,84,101,782,703,79
36047117000,3117000,1974,1959,15,0,459,1312,45,378,105,62,72,636,590,46
36047117201,3117201,2602,2587,15,0,640,1862,49,456,96,91,48,843,801,42
36047117202,3117202,4266,4153,113,0,995,2764,130,841,217,163,151,1347,1251,96
36047117400,3117400,4331,4301,30,0,987,3188,103,520,204,157,159,1372,1270,102
36047117601,3117601,2760,2722,38,9,660,2031,110,342,92,122,63,891,831,60
36047117602,3117602,3492,3492,0,0,872,2503,90,484,176,126,113,1154,1064,90
36047117800,3117800,1820,1813,7,0,403,1055,30,214,280,133,108,561,513,48
36047118000,3118000,7,7,0,0,4,5,0,0,0,2,0,1,1,0
36047118201,3118201,3345,3345,0,0,832,2426,79,375,240,120,105,1013,943,70
36047118202,3118202,3275,3275,0,0,822,2363,75,331,251,151,104,1015,956,59
36047118400,3118400,5434,5434,0,0,1353,3833,113,618,550,184,136,1712,1594,118
36047118600,3118600,3147,3123,24,0,737,1499,79,358,891,198,122,975,897,78
36047118800,3118800,5156,5142,14,0,1284,1600,119,479,2461,275,222,1512,1426,86
36047119000,3119000,2217,2204,13,0,573,815,63,431,615,183,110,724,656,68
36047119200,3119200,3636,3617,19,0,904,1648,73,1335,324,83,173,1267,1151,116
36047119400,3119400,4320,4320,0,0,1097,1449,69,2054,395,106,247,1486,1406,80
36047119600,3119600,6458,6404,54,0,1627,1544,109,1862,2469,193,281,2061,1943,118
36047119800,3119800,3696,3312,384,212,839,2185,133,1120,112,64,82,1157,1054,103
36047120000,3120000,2873,2729,144,0,693,722,73,1059,754,139,126,863,825,38
36047120200,3120200,1972,1962,10,0,453,392,33,215,1050,147,135,581,536,45
36047120801,3120801,3999,3987,12,0,860,880,59,2047,649,86,278,1449,1351,98
36047120802,3120802,3770,3770,0,0,956,520,16,3015,32,38,149,1536,1488,48
36047120803,3120803,2010,1817,193,193,438,599,86,961,203,48,113,653,624,29
36047121000,3121000,3688,3688,0,0,1005,1781,11,1742,61,26,67,1445,1418,27
36047121400,3121400,4100,4100,0,0,1200,1746,59,2115,35,30,115,1508,1488,20
36047122000,3122000,6169,6169,0,0,1621,1272,98,4222,117,102,358,2290,2151,139
36047123700,3123700,8586,8586,0,0,4862,744,7085,128,57,402,170,1763,1677,86
36047150200,3150200,2616,2616,0,0,670,426,1772,57,202,34,125,1071,995,76
36047152200,3152200,3287,3272,15,0,623,458,1493,477,590,52,217,1232,1143,89
36047990100,3990100,0,0,0,0,0,0,0,0,0,0,0,0,0,0
36061000100,1000100,0,0,0,0,0,0,0,0,0,0,0,0,0,0
36061000201,1000201,2012,1982,30,0,352,784,221,244,702,11,50,842,804,38
36061000202,1000202,7266,7082,184,0,1205,2683,1575,942,1832,67,167,3512,3386,126
36061000500,1000500,5,5,0,0,1,0,0,1,2,0,2,25,0,25
36061000600,1000600,11616,11303,313,266,1723,2946,1145,1227,6027,64,207,5790,4833,957
36061000700,1000700,10542,10464,78,0,1030,927,6782,353,1894,105,481,7067,5929,1138
36061000800,1000800,10871,10641,230,0,1430,532,1233,228,8708,62,108,4809,4619,190
36061000900,1000900,2016,1848,168,0,312,223,1148,151,357,32,105,1124,904,220
36061001001,1001001,1767,1767,0,0,315,259,1085,49,272,29,73,907,856,51
36061001002,1001002,6300,5789,511,0,1408,3702,134,1264,1050,47,103,2419,2381,38
36061001200,1001200,3776,3727,49,49,627,1104,1705,118,666,35,148,1851,1779,72
36061001300,1001300,5402,5370,32,0,581,522,3339,169,1045,49,278,3519,3081,438
36061001401,1001401,3543,3543,0,0,679,416,2080,88,718,41,200,1871,1735,136
36061001402,1001402,3418,3319,99,0,312,996,957,287,1023,51,104,1833,1741,92
36061001501,1001501,8385,7355,1030,16,860,763,4745,364,2102,66,345,4465,4104,361
36061001502,1001502,10378,9292,1086,520,1027,993,6335,474,1951,94,531,5519,4789,730
36061001600,1001600,7698,7449,249,0,917,444,1347,229,5470,37,171,3563,3285,278
36061001800,1001800,7934,7379,555,0,845,1122,2551,378,3579,73,231,3942,3601,341
36061002000,1002000,4648,4621,27,0,894,2829,77,867,765,31,79,1874,1851,23
36061002100,1002100,7811,7780,31,0,1961,547,5223,122,1337,84,498,3781,3339,442
36061002201,1002201,6969,6886,83,33,878,2844,1629,799,1457,45,195,3357,3234,123
36061002202,1002202,2488,2295,193,0,209,474,1308,209,374,38,85,1306,1210,96
36061002400,1002400,4518,4483,35,0,986,2719,81,975,645,17,81,1771,1756,15
36061002500,1002500,4630,4630,0,0,818,1780,86,879,1753,42,90,1954,1912,42
36061002601,1002601,3609,3441,168,0,489,1446,1121,401,503,25,113,1638,1567,71
36061002602,1002602,4816,4503,313,0,459,981,2406,391,789,51,198,2455,2302,153
36061002700,1002700,1370,1323,47,5,164,53,232,22,1022,9,32,694,649,45
36061002800,1002800,6819,6697,122,0,829,2609,2164,731,1013,70,232,3582,3371,211
36061002901,1002901,1096,137,959,940,16,318,228,415,119,5,11,91,90,1
36061002902,1002902,4359,4342,17,0,494,158,556,29,3495,14,107,2404,2148,256
36061003001,1003001,4663,4628,35,0,301,754,2575,165,938,37,194,3005,2661,344
36061003002,1003002,3035,3020,15,0,206,640,1577,143,493,70,112,1919,1766,153
36061003100,1003100,2989,1718,1271,3,233,433,1270,340,623,71,252,1181,917,264
36061003200,1003200,8372,8305,67,0,500,1019,5592,233,1126,76,326,5077,4732,345
36061003300,1003300,6458,6436,22,0,1419,380,4832,94,747,31,374,3421,2867,554
36061003400,1003400,7012,6987,25,0,431,1139,4459,244,759,84,327,4564,4100,464
36061003601,1003601,3513,3021,492,0,326,1195,1030,419,742,42,85,1631,1463,168
36061003602,1003602,3000,2532,468,0,179,388,1778,210,473,30,121,1637,1514,123
36061003700,1003700,3092,3069,23,0,408,290,2198,82,338,27,157,2080,1702,378
36061003800,1003800,9070,8626,444,28,392,1132,5909,318,1245,64,402,5799,5262,537
36061003900,1003900,7036,7016,20,0,1557,525,5216,213,622,78,382,3520,3019,501
36061004001,1004001,3743,3604,139,92,166,418,2645,135,359,31,155,2380,2176,204
36061004002,1004002,5090,3680,1410,0,216,545,3149,185,804,93,314,2297,2074,223
36061004100,1004100,7523,6896,627,0,642,569,2594,210,3829,82,239,3962,3526,436
36061004200,1004200,5216,2611,2605,0,205,557,2641,367,1386,39,226,1906,1567,339
36061004300,1004300,4158,4147,11,0,267,545,2556,67,760,52,178,2730,2429,301
36061004400,1004400,17222,17198,24,0,1744,1615,11076,560,2978,141,852,8802,8332,470
36061004500,1004500,1093,1091,2,0,175,53,688,17,251,19,65,595,492,103
36061004700,1004700,2644,2644,0,0,285,220,1987,40,248,19,130,1938,1503,435
36061004800,1004800,6955,6046,909,165,518,622,4766,267,959,70,271,3857,3524,333
36061004900,1004900,4777,4759,18,0,406,355,3619,83,434,37,249,3266,2816,450
36061005000,1005000,5223,5156,67,0,479,286,3935,72,686,26,218,3710,3125,585
36061005200,1005200,3808,3024,784,0,458,284,2457,161,487,83,336,1799,1568,231
36061005400,1005400,4909,4892,17,0,533,294,3676,73,617,29,220,3111,2801,310
36061005501,1005501,4564,4046,518,0,670,384,2990,191,678,43,278,2446,2098,348
36061005502,1005502,1956,1939,17,0,241,126,1483,48,180,18,101,1300,1107,193
36061005600,1005600,4281,3819,462,0,597,498,2541,449,545,48,200,2777,2364,413
36061005700,1005700,2998,2979,19,0,380,127,2388,39,311,14,119,1854,1695,159
36061005800,1005800,5109,5109,0,0,506,484,3543,146,735,37,164,3378,2967,411
36061005900,1005900,5707,4871,836,0,519,394,4259,119,631,53,251,3388,2899,489
36061006000,1006000,5290,5277,13,0,1152,397,3682,147,683,69,312,2489,2362,127
36061006100,1006100,5494,4123,1371,0,522,554,3542,316,708,57,317,2865,2390,475
36061006200,1006200,3686,3265,421,93,406,442,1646,414,971,61,152,1776,1645,131
36061006300,1006300,6707,6442,265,0,706,454,5319,127,447,82,278,4381,3839,542
36061006400,1006400,8744,8421,323,0,692,919,5815,285,1211,128,386,5637,5016,621
36061006500,1006500,6721,5696,1025,0,387,608,4737,197,828,31,320,3863,3502,361
36061006600,1006600,12341,11658,683,0,904,2211,6310,1052,2136,198,434,7262,6773,489
36061006700,1006700,5547,5428,119,92,300,461,4397,83,374,30,202,3895,3500,395
36061006800,1006800,7706,6542,1164,0,459,732,4983,456,1123,106,306,4681,4142,539
36061006900,1006900,2799,2442,357,0,383,219,2073,89,226,40,152,1564,1297,267
36061007001,1007001,4550,4376,174,0,408,411,2943,185,778,39,194,2921,2629,292
36061007002,1007002,4865,4852,13,0,351,389,3408,82,754,28,204,3076,2790,286
36061007100,1007100,5851,5461,390,0,445,490,4501,195,367,54,244,3891,3335,556
36061007200,1007200,9358,8801,557,0,696,766,6451,343,1447,71,280,5761,5195,566
36061007300,1007300,6180,6158,22,0,352,444,4962,98,374,52,250,4491,3982,509
36061007400,1007400,5698,4851,847,0,336,486,3637,291,1040,59,185,3646,3005,641
36061007500,1007500,4000,3978,22,0,477,267,3231,88,210,31,173,2599,2237,362
36061007600,1007600,2921,2606,315,0,210,344,1125,269,1067,22,94,1900,1513,387
36061007700,1007700,6192,6163,29,0,501,480,4898,92,449,37,236,4347,3877,470
36061007800,1007800,9109,9063,46,20,884,692,5421,264,2296,55,381,6011,5343,668
36061007900,1007900,4442,4413,29,0,521,263,3546,90,279,50,214,2963,2580,383
36061008000,1008000,5906,5520,386,0,462,441,4062,243,933,38,189,4003,3369,634
36061008100,1008100,7853,7750,103,0,640,876,5517,229,784,84,363,5420,4794,626
36061008200,1008200,3414,3394,20,0,272,268,2230,86,656,26,148,2515,2062,453
36061008300,1008300,3853,3853,0,0,435,1126,1682,458,432,26,129,2373,2064,309
36061008400,1008400,1985,1600,385,0,113,266,736,282,609,11,81,1878,963,915
36061008601,1008601,4853,4853,0,0,575,408,2441,190,1591,54,169,3366,2605,761
36061008602,1008602,0,0,0,0,0,0,0,0,0,0,0,0,0,0
36061008603,1008603,5347,5347,0,0,563,345,4178,58,550,75,141,3807,3114,693
36061008700,1008700,6510,6492,18,0,592,697,4565,122,770,69,287,4390,3909,481
36061008800,1008800,8852,8837,15,0,716,741,5305,262,2123,64,357,6662,5713,949
36061008900,1008900,5957,5629,328,0,613,933,3787,330,581,80,246,3567,3233,334
36061009000,1009000,8830,8647,183,0,769,622,5226,288,2233,97,364,6051,5191,860
36061009100,1009100,7362,6987,375,21,655,689,4859,420,1025,52,317,4858,4289,569
36061009200,1009200,1866,1814,52,0,112,221,1048,94,427,11,65,1425,1154,271
36061009300,1009300,9325,9233,92,0,1001,1667,5696,690,834,102,336,5781,5386,395
36061009400,1009400,109,104,5,0,13,15,55,10,26,1,2,71,57,14
36061009500,1009500,3892,2457,1435,0,279,1376,1735,290,378,31,82,1697,1414,283
36061009600,1009600,608,205,403,0,18,128,122,242,82,13,21,255,133,122
36061009700,1009700,5071,4593,478,0,461,1334,2231,558,666,62,220,2790,2593,197
36061009800,1009800,8078,8003,75,0,675,589,5413,168,1508,71,329,5783,4799,984
36061009901,1009901,2093,2038,55,0,281,245,1406,88,246,8,100,1373,1124,249
36061009902,1009902,3848,3848,0,0,419,565,2184,271,591,35,202,2598,2353,245
36061009903,1009903,2380,2288,92,0,207,378,959,227,688,33,95,1507,1342,165
36061010000,1010000,2170,1930,240,0,152,240,1291,112,427,13,87,1597,1189,408
36061010100,1010100,2596,1984,612,0,299,377,832,360,910,41,76,1371,1225,146
36061010200,1010200,283,271,12,0,30,35,204,3,31,8,2,329,153,176
36061010300,1010300,4095,3034,1061,0,212,1413,1438,215,861,30,138,2253,1992,261
36061010400,1010400,983,978,5,0,76,96,643,28,168,14,34,1210,618,592
36061010601,1010601,8256,8256,0,0,795,432,6989,46,555,37,197,5585,4795,790
36061010602,1010602,5489,5172,317,0,941,422,3500,313,947,53,254,2952,2610,342
36061010801,1010801,3297,3273,24,0,377,260,2307,66,543,23,98,2174,1976,198
36061010802,1010802,3805,3805,0,0,451,233,2889,46,484,21,132,2462,2173,289
36061010803,1010803,2696,2696,0,0,333,171,1888,24,515,18,80,1965,1555,410
36061010900,1010900,407,256,151,0,23,56,134,77,124,1,15,153,141,12
36061011000,1011000,7671,7658,13,0,943,639,5492,173,1024,60,283,5089,4444,645
36061011100,1011100,6138,5042,1096,0,366,1152,2362,800,1559,49,216,3411,2958,453
36061011201,1011201,1233,1227,6,0,94,139,891,9,148,10,36,994,743,251
36061011202,1011202,500,494,6,0,40,44,370,11,67,3,5,601,283,318
36061011203,1011203,1420,1401,19,0,160,85,961,10,289,14,61,1238,822,416
36061011300,1011300,216,144,72,0,10,35,78,48,49,0,6,130,100,30
36061011401,1011401,1361,1348,13,0,187,81,1076,36,124,14,30,1365,723,642
36061011402,1011402,2620,2583,37,0,334,160,2050,42,241,23,104,1950,1459,491
36061011500,1011500,3863,3566,297,0,342,616,1386,273,1407,45,136,2522,2089,433
36061011600,1011600,3263,3156,107,19,327,344,2177,90,484,35,133,2498,1992,506
36061011700,1011700,5256,5207,49,0,535,949,2149,422,1452,61,223,3521,3156,365
36061011800,1011800,9688,9678,10,0,1320,508,7729,98,936,48,369,6175,5362,813
36061011900,1011900,1666,1076,590,0,244,440,389,708,47,23,59,1060,946,114
36061012000,1012000,3905,3817,88,0,560,181,3288,54,250,24,108,2604,2006,598
36061012101,1012101,3408,3113,295,19,130,567,1575,365,775,36,90,2437,2043,394
36061012102,1012102,5236,5213,23,0,312,882,3325,311,440,47,231,3558,3302,256
36061012200,1012200,3425,3425,0,0,382,193,2930,21,184,26,71,2814,1935,879
36061012400,1012400,10845,10521,324,23,1420,826,7749,207,1588,78,397,6803,6105,698
36061012500,1012500,2901,2558,343,90,156,415,1015,287,1078,39,67,2117,1568,549
36061012601,1012601,7437,7428,9,0,999,468,5797,91,814,36,231,4769,4325,444
36061012602,1012602,6400,6276,124,0,924,363,5292,76,437,39,193,3913,3431,482
36061012700,1012700,7282,7185,97,0,422,1548,3933,295,1108,69,329,4909,4295,614
36061012800,1012800,6545,6493,52,0,1172,321,5623,42,341,60,158,3767,3121,646
36061012901,1012901,7959,7603,356,0,959,1290,3378,825,2074,78,314,5130,4635,495
36061012902,1012902,3144,2794,350,0,253,784,1491,303,392,32,142,1740,1616,124
36061013000,1013000,3911,3908,3,0,543,208,3388,45,191,16,63,2769,1976,793
36061013100,1013100,3962,3636,326,0,351,610,1862,270,1069,24,127,2792,2357,435
36061013201,1013201,3146,3146,0,0,410,211,2313,46,452,14,110,1994,1825,169
36061013202,1013202,4237,4220,17,0,653,368,3029,103,497,30,210,2575,2445,130
36061013203,1013203,3747,3747,0,0,427,269,2739,70,493,20,156,2443,2241,202
36061013300,1013300,6782,6750,32,0,461,1201,3511,242,1479,52,297,4442,3903,539
36061013400,1013400,11882,11641,241,0,1580,938,9155,184,1130,70,405,7470,6712,758
36061013501,1013501,5504,5483,21,0,623,1422,2281,373,1193,37,198,3143,2959,184
36061013502,1013502,6358,6281,77,0,728,1452,2484,664,1417,58,283,3891,3481,410
36061013601,1013601,1962,1962,0,0,283,93,1700,4,104,11,50,1021,952,69
36061013602,1013602,5070,5070,0,0,777,399,3845,94,507,35,190,2941,2673,268
36061013603,1013603,4387,4376,11,0,678,301,3474,78,340,23,171,2581,2408,173
36061013604,1013604,5057,5057,0,0,593,410,3800,92,504,37,214,3185,2876,309
36061013700,1013700,7308,6847,461,0,772,731,4646,358,1283,55,235,5809,4104,1705
36061013800,1013800,13109,12721,388,380,1612,913,9967,281,1438,64,446,8067,7373,694
36061013900,1013900,9988,9645,343,0,566,1218,6091,513,1726,90,350,7275,6305,970
36061014000,1014000,8050,8010,40,19,1476,464,6601,73,619,28,265,4433,3883,550
36061014200,1014200,4463,4437,26,0,762,264,3842,8,208,24,117,2777,2138,639
36061014300,1014300,129,17,112,0,12,32,32,49,2,5,9,5,5,0
36061014401,1014401,5040,5040,0,0,674,379,3994,76,381,25,185,2881,2700,181
36061014402,1014402,7151,7120,31,0,1008,593,5446,128,669,42,273,4236,3936,300
36061014500,1014500,7532,6299,1233,0,834,765,4628,256,1472,82,329,4294,3451,843
36061014601,1014601,4481,4444,37,0,540,369,3230,97,564,44,177,2788,2596,192
36061014602,1014602,9061,9061,0,0,1221,671,6687,142,1103,51,407,5475,5067,408
36061014700,1014700,2987,2968,19,0,556,265,1643,60,845,27,147,1822,1537,285
36061014801,1014801,3221,3211,10,0,634,185,2485,28,350,24,149,1759,1555,204
36061014802,1014802,7494,7486,8,0,1242,464,5889,65,751,59,266,4206,3659,547
36061014900,1014900,6351,5952,399,0,957,397,4817,117,720,26,274,4108,3368,740
36061015001,1015001,2321,2321,0,0,412,80,1968,15,147,20,91,1298,1084,214
36061015002,1015002,5642,5628,14,0,985,266,4862,30,306,24,154,2932,2568,364
36061015101,1015101,3756,3756,0,0,693,1670,468,1047,434,40,97,1842,1733,109
36061015102,1015102,8254,8230,24,0,1729,1247,4036,599,1913,66,393,5868,4058,1810
36061015200,1015200,7730,7718,12,0,1349,1562,4107,926,794,82,259,3980,3829,151
36061015301,1015301,3684,3666,18,0,490,269,2949,41,272,17,136,2339,2009,330
36061015302,1015302,6032,6005,27,0,961,413,4416,67,825,29,282,3867,3319,548
36061015401,1015401,5189,5182,7,0,596,454,3636,195,623,34,247,3182,2992,190
36061015402,1015402,4503,4503,0,0,574,457,3025,130,631,36,224,2549,2401,148
36061015403,1015403,5738,5605,133,0,1001,868,3348,416,846,44,216,2940,2816,124
36061015501,1015501,5091,5091,0,0,695,226,3875,55,693,32,210,3479,3005,474
36061015502,1015502,5759,5759,0,0,960,397,4122,128,860,57,195,3457,3076,381
36061015601,1015601,5568,5438,130,78,646,730,3371,309,921,44,193,3256,2882,374
36061015602,1015602,2154,2143,11,0,388,719,661,311,369,30,64,1096,1030,66
36061015700,1015700,11197,10680,517,0,1296,871,8492,264,955,193,422,7056,6188,868
36061015801,1015801,5600,5376,224,0,908,435,4278,109,502,37,239,2935,2667,268
36061015802,1015802,4516,3527,989,0,440,706,2443,317,833,37,180,2071,1932,139
36061015900,1015900,10054,9990,64,0,1578,632,7555,186,1117,108,456,6413,5417,996
36061016001,1016001,3852,3828,24,0,729,220,3273,33,198,22,106,1942,1684,258
36061016002,1016002,3607,3059,548,0,494,476,2288,152,566,26,99,1490,1374,116
36061016100,1016100,6617,6601,16,0,870,539,5116,125,505,36,296,4228,3691,537
36061016200,1016200,9033,8995,38,7,1692,3862,585,3364,920,73,229,4070,3915,155
36061016300,1016300,7292,6722,570,180,1126,651,5282,326,612,56,365,4325,3609,716
36061016400,1016400,7371,7371,0,0,1654,3681,831,1888,736,70,165,3171,3094,77
36061016500,1016500,6659,6639,20,0,1090,551,5151,140,479,21,317,3936,3379,557
36061016600,1016600,7012,6521,491,0,1256,3477,1453,1205,565,77,235,3307,3087,220
36061016700,1016700,7210,6960,250,0,1373,562,5546,206,540,78,278,3817,3364,453
36061016800,1016800,4964,4272,692,692,914,2276,926,1338,291,35,98,1889,1786,103
36061016900,1016900,8526,8427,99,99,1211,1027,6244,254,598,85,318,4909,4419,490
36061017000,1017000,7991,7628,363,0,1342,4251,870,1272,1283,96,219,3467,3341,126
36061017100,1017100,9694,9004,690,0,1630,979,7188,411,586,115,415,4956,4549,407
36061017200,1017200,5441,5413,28,0,1048,2985,755,1026,419,69,187,2456,2304,152
36061017300,1017300,8699,8488,211,0,1319,1274,5779,569,569,64,444,5012,4434,578
36061017401,1017401,5449,5230,219,0,1114,2420,717,1610,510,38,154,2301,2181,120
36061017402,1017402,2276,2259,17,0,345,820,435,687,225,20,89,1068,993,75
36061017500,1017500,11110,10137,973,270,1621,1313,8126,440,697,116,418,5744,4943,801
36061017700,1017700,9382,9382,0,0,1409,2241,4755,1253,612,92,429,5101,4744,357
36061017800,1017800,3860,3836,24,0,627,2016,818,687,146,49,144,1897,1727,170
36061017900,1017900,9103,8787,316,0,1204,1302,6057,573,726,91,354,5255,4609,646
36061018000,1018000,7429,7395,34,0,1582,4354,779,1541,487,67,201,3139,3005,134
36061018100,1018100,8941,8934,7,0,1317,1421,5108,1024,879,104,405,4753,4431,322
36061018200,1018200,7675,7106,569,0,1652,4130,754,2002,473,121,195,3079,2909,170
36061018300,1018300,8534,8015,519,57,1078,1125,5494,484,907,120,404,4751,4148,603
36061018400,1018400,7820,7798,22,0,1728,3718,680,2609,441,95,277,3413,3297,116
36061018500,1018500,5243,5223,20,0,651,482,3072,465,934,66,224,3309,3016,293
36061018600,1018600,5127,5016,111,0,1119,1946,348,2356,206,87,184,2174,2070,104
36061018700,1018700,9383,8884,499,50,1536,1482,5752,838,764,119,428,4696,4323,373
36061018800,1018800,5697,5579,118,0,1157,3288,856,1074,269,59,151,2547,2295,252
36061018900,1018900,11556,10920,636,516,1822,4692,3061,2620,715,90,378,5327,5005,322
36061019000,1019000,3679,3657,22,0,781,753,756,1617,312,46,195,1765,1668,97
36061019100,1019100,9005,8669,336,0,1166,1431,5528,731,887,68,360,4951,4575,376
36061019200,1019200,3971,3738,233,0,954,2064,187,1403,184,36,97,1551,1504,47
36061019300,1019300,8736,8428,308,34,1071,3458,2473,1347,1023,110,325,4318,4065,253
36061019400,1019400,6978,6625,353,0,1457,3871,578,1990,260,70,209,2883,2705,178
36061019500,1019500,7828,7306,522,0,893,1407,4453,401,1120,78,369,3932,3485,447
36061019600,1019600,4031,3506,525,286,536,1837,554,1241,227,39,133,1801,1692,109
36061019701,1019701,1278,1235,43,0,148,196,385,155,482,24,36,896,687,209
36061019702,1019702,2601,2531,70,0,367,431,914,734,316,25,181,1301,1206,95
36061019800,1019800,2370,2175,195,139,324,452,561,1034,212,11,100,1135,1073,62
36061019900,1019900,9598,6848,2750,355,898,1300,4967,784,1927,112,508,4030,3537,493
36061020000,1020000,2855,2706,149,0,362,412,859,1205,171,31,177,1548,1388,160
36061020101,1020101,1863,834,1029,0,138,219,839,173,523,28,81,487,411,76
36061020102,1020102,4077,4049,28,0,683,850,1173,1566,196,32,260,1906,1773,133
36061020300,1020300,3874,791,3083,0,101,606,1427,504,1097,58,182,508,438,70
36061020500,1020500,5023,2614,2409,0,423,465,2991,274,928,66,299,1360,1219,141
36061020600,1020600,3628,3431,197,0,638,870,613,1801,115,34,195,1831,1697,134
36061020701,1020701,3035,2446,589,0,205,302,1466,153,910,34,170,1500,1361,139
36061020800,1020800,5255,5159,96,0,887,794,1001,2955,186,60,259,2655,2391,264
36061020901,1020901,3665,3608,57,0,733,1608,267,1497,168,25,100,1539,1482,57
36061021000,1021000,6748,6739,9,0,1417,2009,162,4177,145,47,208,3149,3039,110
36061021100,1021100,10529,9408,1121,0,1358,2853,3340,1736,2028,174,398,4726,4407,319
36061021200,1021200,4899,4435,464,213,626,909,611,2893,211,61,214,2803,2655,148
36061021303,1021303,5583,5238,345,0,830,1852,1171,1966,295,66,233,2532,2340,192
36061021400,1021400,3075,3056,19,0,334,427,312,2036,133,32,135,1958,1849,109
36061021500,1021500,3856,3856,0,0,827,1032,434,2083,112,39,156,1668,1602,66
36061021600,1021600,8567,8325,242,0,1535,1877,2073,3590,524,112,391,3892,3648,244
36061021703,1021703,545,42,503,0,18,101,202,123,89,12,18,8,3,5
36061021800,1021800,6530,6353,177,0,1066,1153,1365,3348,292,79,293,3117,2920,197
36061021900,1021900,5696,5525,171,23,1358,3213,278,1920,115,66,104,2205,2064,141
36061022000,1022000,6114,5845,269,0,1194,1151,1457,2808,257,90,351,2859,2613,246
36061022102,1022102,2382,2344,38,0,358,328,570,1226,93,26,139,1279,1203,76
36061022200,1022200,3293,3089,204,0,545,566,829,1522,182,35,159,1553,1437,116
36061022301,1022301,7258,6982,276,0,1034,5087,1104,534,291,95,147,2567,2422,145
36061022302,1022302,3101,3101,0,0,409,1747,432,577,246,16,83,1552,1447,105
36061022400,1022400,7346,6932,414,0,1692,2543,637,3718,163,72,213,3052,2908,144
36061022500,1022500,9895,9611,284,0,1588,5891,1498,1800,303,114,289,3870,3648,222
36061022600,1022600,4890,4547,343,0,864,1055,803,2600,193,53,186,2410,2190,220
36061022700,1022700,5387,4955,432,0,800,1513,1296,2027,220,78,253,2526,2314,212
36061022800,1022800,5961,5560,401,0,969,1143,915,3387,160,72,284,3057,2652,405
36061022900,1022900,7975,7869,106,0,1191,4472,1307,1622,261,76,237,3298,3017,281
36061023000,1023000,9111,8955,156,0,1731,2087,924,5391,233,102,374,4301,3952,349
36061023100,1023100,6273,6108,165,0,911,2062,1397,2156,267,73,318,2984,2739,245
36061023200,1023200,8061,7781,280,0,1888,2561,396,4646,134,95,229,3363,3215,148
36061023300,1023300,6368,6350,18,0,889,2770,1517,1466,292,64,259,2741,2544,197
36061023400,1023400,5112,5112,0,0,996,1286,761,2622,154,55,234,2369,2279,90
36061023501,1023501,6720,6296,424,0,1086,2724,1191,2308,157,56,284,2698,2555,143
36061023502,1023502,2206,2173,33,0,432,484,235,1295,86,17,89,1016,963,53
36061023600,1023600,9907,9899,8,0,1783,1749,265,7431,91,86,285,5158,4887,271
36061023700,1023700,6792,6663,129,0,992,3542,1215,1547,185,71,232,2873,2690,183
36061023802,1023802,4791,4331,460,460,811,686,1512,585,1574,223,211,1983,1802,181
36061023803,1023803,3625,3615,10,0,391,478,1425,585,885,46,206,1817,1637,180
36061023804,1023804,3306,3290,16,0,570,276,1314,67,1438,64,147,1808,1675,133
36061023900,1023900,2675,2657,18,0,434,1273,417,790,78,28,89,1228,1147,81
36061024000,1024000,1302,86,1216,196,27,466,170,621,13,8,24,28,22,6
36061024100,1024100,7612,7566,46,0,1013,3828,1649,1517,295,69,254,3472,3316,156
36061024200,1024200,4448,4399,49,0,1168,1995,189,1961,136,42,125,1899,1821,78
36061024301,1024301,3993,3783,210,146,646,2093,629,1052,84,28,107,1531,1450,81
36061024302,1024302,7237,7104,133,0,2011,3436,81,3327,177,65,151,2738,2694,44
36061024500,1024500,13385,13278,107,0,2110,9641,1678,1249,459,122,236,5152,4817,335
36061024700,1024700,6521,6521,0,0,894,4229,1241,612,204,55,180,2709,2570,139
36061024900,1024900,1084,1064,20,0,148,627,158,173,78,10,38,471,450,21
36061025100,1025100,2287,2076,211,0,325,1640,240,238,103,23,43,897,847,50
36061025300,1025300,10081,9971,110,36,1461,7341,1584,532,368,77,179,3990,3798,192
36061025500,1025500,5697,4689,1008,62,561,2370,1805,370,896,57,199,2245,2069,176
36061025700,1025700,4270,4254,16,0,836,755,1348,1577,251,56,283,1961,1853,108
36061025900,1025900,4029,3809,220,0,880,1176,711,1677,215,64,186,1726,1704,22
36061026100,1026100,10733,10601,132,0,1885,9181,559,679,91,96,127,3798,3642,156
36061026300,1026300,7969,7952,17,0,1191,6224,926,429,179,85,126,2964,2850,114
36061026500,1026500,6850,6775,75,0,933,3874,2111,316,288,65,196,3009,2762,247
36061026700,1026700,2083,1597,486,0,322,835,1135,36,27,19,31,671,634,37
36061026900,1026900,7848,7494,354,0,1232,6356,777,454,120,46,95,2851,2671,180
36061027100,1027100,7623,7616,7,0,1148,4945,2020,215,197,98,148,3094,2921,173
36061027300,1027300,6519,6509,10,0,975,1571,4029,229,315,88,287,3337,3216,121
36061027500,1027500,3063,3063,0,0,485,480,2075,117,209,24,158,1632,1503,129
36061027700,1027700,6423,5876,547,467,1076,5234,658,306,89,42,94,2213,2092,121
36061027900,1027900,10019,10008,11,0,1641,7058,2066,381,206,116,192,4271,4087,184
36061028100,1028100,3108,2918,190,180,598,520,2107,152,151,39,139,1440,1373,67
36061028300,1028300,7740,7724,16,0,1187,5211,1466,509,315,70,169,3517,3365,152
36061028500,1028500,6794,6784,10,0,1189,5539,676,294,135,55,95,2794,2697,97
36061028700,1028700,3772,3745,27,0,598,2209,1149,173,89,36,116,1721,1628,93
36061029100,1029100,10509,10509,0,0,1922,8885,796,482,117,103,126,4013,3909,104
36061029300,1029300,8035,8017,18,0,1499,6838,604,295,103,80,115,3037,2965,72
36061029500,1029500,7039,7013,26,0,1079,3762,2362,390,242,52,231,3432,3283,149
36061029700,1029700,16,13,3,3,3,6,0,5,0,0,5,3,0,3
36061029900,1029900,3598,3526,72,0,680,2647,78,763,25,30,55,1528,1507,21
36061030300,1030300,3691,3682,9,0,549,1873,1331,176,133,40,138,1824,1740,84
36061030700,1030700,3427,3427,0,0,503,946,1896,225,155,25,180,1878,1767,111
36061030900,1030900,8594,8587,7,0,1856,6008,547,1658,130,75,176,3578,3483,95
36061031100,1031100,12,0,12,0,3,8,0,2,0,1,1,0,0,0
36061031703,1031703,5847,5811,36,0,1705,449,3840,107,1029,33,389,2801,2407,394
36061031704,1031704,10422,10395,27,0,2072,832,6349,161,2435,87,558,5462,5011,451
36061031900,1031900,3,3,0,0,1,2,0,0,0,0,1,1,0,1
36081000101,4000101,4659,4644,15,0,805,671,2292,176,1224,53,243,2403,2304,99
36081000102,4000102,7484,7484,0,0,1056,730,4156,235,1832,187,344,4201,3902,299
36081000103,4000103,33,33,0,0,2,0,9,2,18,1,3,18,14,4
36081000104,4000104,27,27,0,0,8,13,1,7,1,1,4,17,14,3
36081000200,4000200,3084,3072,12,0,661,1830,367,118,607,81,81,982,936,46
36081000400,4000400,4918,4918,0,0,1133,3301,225,263,795,202,132,1456,1359,97
36081000600,4000600,4177,4164,13,0,995,2591,302,246,671,223,144,1285,1193,92
36081000701,4000701,3460,3460,0,0,592,508,1739,66,896,58,193,1855,1661,194
36081000702,4000702,4260,4119,141,0,559,816,1963,186,1056,45,194,2172,2012,160
36081000800,4000800,3580,3580,0,0,755,2169,336,167,670,123,115,1074,1016,58
36081001000,4001000,3789,3789,0,0,848,2382,320,128,812,85,62,1081,1031,50
36081001200,4001200,4183,4177,6,0,781,2353,674,149,849,100,58,1379,1318,61
36081001400,4001400,4114,4107,7,0,873,2507,611,144,714,79,59,1242,1185,57
36081001600,4001600,3041,3034,7,0,588,1871,316,94,666,47,47,876,841,35
36081001800,4001800,3044,3033,11,0,641,1792,310,124,641,87,90,929,881,48
36081001901,4001901,1434,1430,4,0,180,163,649,49,467,14,92,855,751,104
36081001902,4001902,8645,8639,6,0,561,792,2716,337,4358,111,331,6170,4979,1191
36081001903,4001903,2214,2214,0,0,138,188,821,52,1075,15,63,1393,1229,164
36081002000,4002000,1871,1871,0,0,403,1027,196,62,468,40,78,544,520,24
36081002200,4002200,2290,2283,7,0,424,1448,322,122,315,38,45,788,759,29
36081002400,4002400,2195,2191,4,0,479,1342,240,143,353,55,62,702,672,30
36081002500,4002500,7242,7242,0,0,1681,2945,178,3128,673,80,238,3156,3099,57
36081002600,4002600,2150,2132,18,0,489,1030,363,208,383,107,59,668,627,41
36081002800,4002800,3304,3304,0,0,736,1906,304,210,484,266,134,1085,1023,62
36081003000,4003000,1479,1479,0,0,282,778,200,54,299,94,54,454,436,18
36081003100,4003100,2157,1995,162,0,197,638,741,174,457,56,91,1085,957,128
36081003200,4003200,1791,1787,4,0,380,1018,171,127,273,90,112,555,521,34
36081003301,4003301,4399,4294,105,0,248,547,1650,246,1707,40,209,2518,2345,173
36081003302,4003302,2166,1942,224,0,321,652,414,186,792,34,88,739,688,51
36081003400,4003400,2442,2419,23,0,549,1227,196,172,630,130,87,736,694,42
36081003600,4003600,4195,4195,0,0,989,1858,277,217,1519,195,129,1190,1118,72
36081003700,4003700,2,2,0,0,1,1,1,0,0,0,0,171,1,170
36081003800,4003800,2490,2476,14,0,581,1338,265,114,500,106,167,802,749,53
36081003900,4003900,1462,1369,93,0,282,778,376,45,190,26,47,518,471,47
36081004001,4004001,2403,2389,14,0,522,1051,475,140,487,150,100,792,750,42
36081004002,4004002,1361,1361,0,0,330,472,118,73,514,73,111,447,417,30
36081004200,4004200,4505,4505,0,0,1043,1384,277,228,2254,199,163,1310,1231,79
36081004300,4004300,2326,2326,0,0,507,1026,107,945,141,31,76,1071,1046,25
36081004401,4004401,3916,3916,0,0,884,948,270,166,2180,178,174,1115,1083,32
36081004500,4004500,3252,3252,0,0,450,670,1681,141,611,37,112,1649,1546,103
36081004700,4004700,4090,4090,0,0,795,1335,899,1099,541,50,166,1889,1844,45
36081005000,4005000,0,0,0,0,0,0,0,0,0,0,0,0,0,0
36081005100,4005100,2512,2509,3,0,410,530,750,49,1040,45,98,1012,960,52
36081005200,4005200,3080,3048,32,0,787,1024,223,221,1281,195,136,863,823,40
36081005300,4005300,5397,5397,0,0,572,979,2689,68,1243,136,282,2727,2609,118
36081005400,4005400,5609,5595,14,0,1153,2134,887,433,1510,437,208,1806,1720,86
36081005500,4005500,1367,1367,0,0,183,459,380,32,402,29,65,639,582,57
36081005700,4005700,4277,4277,0,0,522,1288,1790,65,909,64,161,2009,1931,78
36081005800,4005800,6194,6046,148,0,1350,2705,1398,539,1238,153,161,2141,2022,119
36081005900,4005900,4231,4220,11,0,434,918,2334,94,637,44,204,2119,2005,114
36081006100,4006100,6291,6290,1,0,641,1301,3446,91,1083,99,271,3359,3219,140
36081006201,4006201,5389,5380,9,0,709,1633,3011,299,263,64,119,2977,2837,140
36081006202,4006202,6949,6915,34,0,1493,2873,2777,384,608,95,212,2662,2555,107
36081006300,4006300,5877,5859,18,0,557,1255,3405,103,753,83,278,2963,2852,111
36081006501,4006501,3645,3645,0,0,341,843,1983,79,512,77,151,1983,1886,97
36081006502,4006502,4004,4004,0,0,418,930,2295,50,545,37,147,2032,1914,118
36081006900,4006900,5196,4904,292,268,572,1584,2357,98,897,73,187,2476,2367,109
36081007100,4007100,4355,4339,16,0,473,939,2276,109,733,74,224,2184,2075,109
36081007300,4007300,4470,4470,0,0,446,886,2535,92,726,51,180,2438,2333,105
36081007500,4007500,4477,4470,7,0,472,992,2196,90,944,67,188,2430,2323,107
36081007700,4007700,2114,2108,6,0,289,523,917,74,433,71,96,1028,982,46
36081007900,4007900,3628,3628,0,0,568,1064,1403,95,846,109,111,1549,1483,66
36081008100,4008100,1761,1761,0,0,270,471,810,74,294,29,83,881,805,76
36081008300,4008300,3515,3255,260,0,528,1326,1191,371,425,53,149,1394,1315,79
36081008500,4008500,1979,1320,659,0,370,676,456,474,245,58,70,456,429,27
36081008600,4008600,2989,2967,22,0,565,1284,766,143,468,198,130,1009,971,38
36081008700,4008700,5176,5176,0,0,1229,2078,580,1958,274,97,189,2097,1983,114
36081008800,4008800,3449,3429,20,0,688,1501,1114,246,364,121,103,1227,1170,57
36081009100,4009100,2733,2724,9,0,382,738,1385,87,363,27,133,1348,1265,83
36081009400,4009400,2919,2918,1,0,645,650,160,508,768,533,300,905,859,46
36081009500,4009500,2510,2510,0,0,355,432,1623,49,271,36,99,1087,1030,57
36081009600,4009600,3127,3127,0,0,603,579,191,488,887,646,336,974,933,41
36081009700,4009700,3860,3860,0,0,623,549,2704,51,317,43,196,1759,1677,82
36081009800,4009800,2631,2631,0,0,499,365,172,290,830,543,431,849,808,41
36081009900,4009900,0,0,0,0,0,0,0,0,0,0,0,0,0,0
36081010000,4010000,3383,3376,7,0,571,786,262,375,985,657,318,1011,994,17
36081010100,4010100,2654,2654,0,0,354,409,1870,39,183,46,107,1228,1153,75
36081010200,4010200,2866,2866,0,0,511,497,238,351,980,387,413,863,829,34
36081010300,4010300,4150,4150,0,0,643,721,2521,82,623,37,166,2031,1915,116
36081010400,4010400,3315,3315,0,0,608,525,234,370,1144,676,366,1016,981,35
36081010500,4010500,4641,4641,0,0,981,1348,2212,232,626,59,164,1784,1754,30
36081010600,4010600,3417,3382,35,0,682,532,174,363,1373,564,411,1016,968,48
36081010701,4010701,7,7,0,0,1,6,1,0,0,0,0,2,2,0
36081010800,4010800,3034,3024,10,0,646,609,113,328,1238,497,249,886,838,48
36081011000,4011000,3190,3182,8,0,659,830,145,282,1025,666,242,941,924,17
36081011100,4011100,2902,2902,0,0,401,595,1797,37,343,29,101,1349,1289,60
36081011200,4011200,2497,2488,9,0,539,781,290,146,772,299,209,790,750,40
36081011300,4011300,4280,4275,5,0,482,992,2438,77,566,55,152,2113,1946,167
36081011400,4011400,1539,1523,16,0,339,706,194,117,322,120,80,447,426,21
36081011500,4011500,2414,2413,1,0,257,504,1442,45,270,24,129,1199,1130,69
36081011600,4011600,2370,2370,0,0,503,816,216,149,617,275,297,661,635,26
36081011700,4011700,3840,3826,14,0,463,602,2574,57,423,48,136,1840,1733,107
36081011800,4011800,2690,2690,0,0,567,839,174,128,1073,308,168,791,759,32
36081011900,4011900,1729,1729,0,0,182,367,1102,27,137,24,72,866,806,60
36081012000,4012000,2385,2385,0,0,501,502,115,104,1357,189,118,736,692,44
36081012100,4012100,2177,2164,13,0,284,344,1476,19,224,23,91,1040,966,74
36081012200,4012200,2802,2802,0,0,550,1026,185,206,976,218,191,932,851,81
36081012301,4012301,3272,3272,0,0,451,598,2220,73,221,55,105,1473,1385,88
36081012400,4012400,2873,2868,5,0,614,1228,202,223,750,282,188,905,858,47
36081012500,4012500,1735,1735,0,0,188,422,934,37,241,24,77,799,760,39
36081012601,4012601,2596,2596,0,0,527,1365,216,202,444,246,123,799,747,52
36081012602,4012602,2715,2715,0,0,580,1513,219,174,488,220,101,838,797,41
36081012800,4012800,2212,2209,3,0,455,982,610,101,283,125,111,764,712,52
36081013000,4013000,1757,1737,20,0,434,674,571,83,303,52,74,576,544,32
36081013200,4013200,1919,1897,22,0,387,674,643,136,347,44,75,680,649,31
36081013400,4013400,5904,5730,174,0,987,1548,2711,536,733,73,303,2874,2705,169
36081013500,4013500,1526,1526,0,0,257,198,1206,13,67,14,28,701,656,45
36081013600,4013600,1994,1994,0,0,337,555,896,147,274,50,72,950,873,77
36081013700,4013700,1747,1747,0,0,227,333,1160,54,125,25,50,875,806,69
36081013800,4013800,3785,3782,3,0,711,1197,1154,217,982,98,137,1580,1492,88
36081014000,4014000,3952,3941,11,0,881,1091,1558,271,713,125,194,1580,1474,106
36081014100,4014100,1645,1645,0,0,229,410,938,26,169,12,90,772,722,50
36081014201,4014201,4702,4702,0,0,1087,1978,187,556,1327,387,267,1508,1444,64
36081014202,4014202,2870,2491,379,262,534,1309,145,259,753,242,162,736,700,36
36081014300,4014300,4007,4007,0,0,624,1002,2107,77,574,75,172,1810,1713,97
36081014400,4014400,2005,2000,5,0,443,738,120,120,789,124,114,642,600,42
36081014500,4014500,2368,2362,6,0,362,499,1440,34,236,43,116,1061,989,72
36081014700,4014700,2933,2917,16,0,367,648,1764,60,258,55,148,1438,1338,100
36081014800,4014800,2186,2172,14,0,422,475,73,189,912,390,147,634,601,33
36081014900,4014900,2477,2477,0,0,367,765,1253,23,272,43,121,1088,1023,65
36081015000,4015000,2418,2418,0,0,489,529,82,236,990,308,273,701,658,43
36081015100,4015100,2675,2661,14,0,312,646,1455,51,335,61,127,1307,1229,78
36081015200,4015200,2638,2638,0,0,452,653,101,342,809,533,200,829,800,29
36081015300,4015300,2131,2086,45,0,222,413,1138,54,371,41,114,1070,998,72
36081015400,4015400,2390,2385,5,0,478,421,103,232,946,422,266,738,702,36
36081015500,4015500,2344,2334,10,0,277,546,1261,32,371,45,89,1085,1035,50
36081015600,4015600,3210,3210,0,0,611,457,64,464,1298,483,444,946,917,29
36081015700,4015700,1655,1655,0,0,245,523,599,39,401,38,55,796,770,26
36081015801,4015801,3817,3799,18,3,669,614,58,937,1015,762,431,1130,1072,58
36081015802,4015802,4607,4587,20,0,801,600,107,733,1183,1321,663,1403,1353,50
36081015900,4015900,4010,4010,0,0,444,939,2102,95,575,95,204,2053,1938,115
36081016100,4016100,2291,2291,0,0,360,898,725,32,466,52,118,891,842,49
36081016300,4016300,4053,4053,0,0,804,1664,590,1090,485,58,166,1721,1682,39
36081016400,4016400,3306,3296,10,10,642,344,54,739,797,810,562,978,931,47
36081016600,4016600,3400,3393,7,7,520,595,92,594,846,684,589,1113,1050,63
36081016800,4016800,2764,2746,18,0,498,631,81,493,597,617,345,862,826,36
36081016900,4016900,5577,5577,0,0,897,1398,2567,74,1304,34,200,2545,2414,131
36081017000,4017000,2504,2489,15,0,473,326,68,703,485,558,364,811,763,48
36081017101,4017101,36,22,14,0,6,11,8,9,3,0,5,5,5,0
36081017102,4017102,27,21,6,0,12,9,1,7,6,0,4,7,4,3
36081017200,4017200,2224,2224,0,0,384,278,26,663,390,552,315,670,654,16
36081017400,4017400,2423,2414,9,0,469,468,38,754,419,467,277,736,688,48
36081017600,4017600,2181,2165,16,0,417,331,54,750,476,333,237,647,616,31
36081017800,4017800,2084,2065,19,0,433,310,26,677,417,372,282,624,593,31
36081017901,4017901,986,986,0,0,161,351,317,15,253,19,31,455,435,20
36081017902,4017902,124,31,93,0,3,26,26,67,1,1,3,9,6,3
36081018000,4018000,1365,1365,0,0,343,231,96,398,316,164,160,411,391,20
36081018101,4018101,3836,3834,2,0,533,1382,1310,59,947,33,105,1769,1702,67
36081018102,4018102,3800,3800,0,0,484,817,1827,66,925,36,129,1989,1898,91
36081018200,4018200,2540,2504,36,24,516,467,63,1220,325,250,215,796,757,39
36081018300,4018300,6044,6016,28,0,948,1850,2437,101,1412,42,202,2808,2672,136
36081018401,4018401,2174,2174,0,0,520,246,13,1397,154,166,198,714,679,35
36081018402,4018402,2412,2401,11,0,506,277,18,1392,262,220,243,723,678,45
36081018501,4018501,3502,3502,0,0,502,1068,1340,85,828,50,131,1728,1654,74
36081018502,4018502,3453,3439,14,0,499,1027,1361,71,827,47,120,1600,1531,69
36081018600,4018600,1802,1802,0,0,381,243,48,789,223,238,261,565,532,33
36081018700,4018700,3611,3212,399,0,746,1286,943,300,901,78,103,1272,1187,85
36081018800,4018800,1510,1491,19,0,329,232,17,765,172,212,112,449,429,20
36081018900,4018900,3457,3457,0,0,482,1181,947,121,1063,52,93,1500,1363,137
36081019000,4019000,2445,2445,0,0,482,282,56,1343,231,285,248,723,693,30
36081019200,4019200,2359,2359,0,0,451,361,42,1224,298,288,146,760,722,38
36081019400,4019400,3015,3015,0,0,570,493,35,1453,431,371,232,948,885,63
36081019600,4019600,3122,3122,0,0,709,600,31,1460,409,360,262,1008,953,55
36081019800,4019800,3682,3682,0,0,921,803,33,1387,892,355,212,1077,1014,63
36081019901,4019901,1088,601,487,186,331,475,125,376,68,28,16,228,211,17
36081019902,4019902,317,47,270,0,9,93,38,169,0,10,7,18,18,0
36081019903,4019903,0,0,0,0,0,0,0,0,0,0,0,0,0,0
36081020200,4020200,1693,1592,101,0,356,307,40,587,383,237,139,473,450,23
36081020400,4020400,2278,2257,21,21,491,609,51,716,623,156,123,731,672,59
36081020500,4020500,1184,1171,13,0,248,732,185,21,210,20,16,431,380,51
36081020600,4020600,2046,2046,0,0,469,883,114,332,433,161,123,595,574,21
36081020800,4020800,3513,3391,122,0,718,1269,279,1115,472,173,205,1471,1170,301
36081021200,4021200,2812,2614,198,0,744,1693,134,254,426,151,154,785,753,32
36081021400,4021400,6673,6582,91,0,1333,2130,677,725,2594,278,269,2284,2179,105
36081021601,4021601,2678,2678,0,0,291,599,1008,302,592,60,117,1527,1434,93
36081021602,4021602,1506,1462,44,0,294,705,145,205,308,98,45,502,481,21
36081021603,4021603,0,0,0,0,0,0,0,0,0,0,0,0,0,0
36081021900,4021900,31,24,7,0,14,9,10,5,2,0,5,9,9,0
36081022001,4022001,6551,6244,307,0,1272,1984,1662,1136,1430,115,224,2954,2809,145
36081022002,4022002,6010,6010,0,0,1000,1422,1831,661,1711,142,243,2785,2642,143
36081022900,4022900,0,0,0,0,0,0,0,0,0,0,0,0,0,0
36081023000,4023000,1880,1880,0,0,333,437,406,102,771,72,92,588,563,25
36081023200,4023200,5264,4992,272,263,969,1550,774,567,1926,183,264,1937,1827,110
36081023501,4023501,4403,4393,10,0,882,2495,366,34,1408,55,45,1473,1396,77
36081023502,4023502,3373,3356,17,0,607,1675,442,29,1129,43,55,1200,1153,47
36081023600,4023600,3266,3263,3,3,631,923,185,490,1475,97,96,1626,1242,384
36081023800,4023800,4863,4835,28,0,1137,1828,85,627,1973,223,127,1526,1485,41
36081024000,4024000,6252,6209,43,0,1437,2782,189,1098,1642,306,235,2213,2155,58
36081024300,4024300,6231,6231,0,0,1294,2429,1062,47,2558,54,81,2067,1931,136
36081024500,4024500,5544,5464,80,0,847,1783,1717,170,1686,48,140,2262,2179,83
36081024600,4024600,1,0,1,0,1,0,1,0,0,0,0,0,0,0
36081024700,4024700,1537,1537,0,0,268,514,178,21,780,17,27,559,522,37
36081024900,4024900,5724,5511,213,213,767,1418,1146,107,2869,69,115,2298,2194,104
36081025100,4025100,5818,5725,93,0,889,1966,1596,146,1936,57,117,2515,2386,129
36081025301,4025301,4510,4494,16,0,648,1704,1488,81,1044,45,148,2105,2014,91
36081025302,4025302,3013,2997,16,0,522,1397,676,47,803,28,62,1294,1231,63
36081025401,4025401,3899,3871,28,9,1001,662,29,1927,934,147,200,1147,1067,80
36081025402,4025402,6180,5993,187,0,1424,1234,129,3283,1010,208,316,2332,2214,118
36081025500,4025500,1603,1603,0,0,237,545,363,20,630,4,41,608,578,30
36081025700,4025700,1648,1638,10,0,274,562,258,18,761,10,39,618,559,59
36081025800,4025800,2289,2289,0,0,566,379,11,1195,476,103,125,672,622,50
36081025900,4025900,3542,3536,6,0,642,1285,449,59,1655,34,60,1265,1196,69
36081026000,4026000,2915,2915,0,0,770,637,36,1557,471,100,114,899,859,40
36081026100,4026100,7802,7792,10,0,1538,2845,522,101,4189,43,102,2545,2467,78
36081026200,4026200,1652,1652,0,0,348,276,8,960,204,69,135,478,456,22
36081026300,4026300,6631,6609,22,0,1143,2216,543,75,3673,47,77,2288,2178,110
36081026400,4026400,2736,2708,28,28,567,456,21,1741,246,105,167,927,880,47
36081026501,4026501,3213,3213,0,0,558,680,234,38,2167,32,62,1280,1156,124
36081026502,4026502,1622,1622,0,0,390,448,84,16,1034,12,28,493,470,23
36081026600,4026600,1949,1934,15,0,297,219,25,1353,194,38,120,849,815,34
36081026700,4026700,6196,6160,36,8,1134,2369,279,57,3321,87,83,2221,2107,114
36081026901,4026901,5210,5210,0,0,1069,3083,182,39,1798,46,62,1666,1609,57
36081026902,4026902,4244,4244,0,0,801,1571,181,33,2378,28,53,1493,1415,78
36081027000,4027000,1960,1951,9,0,422,322,26,1174,177,132,129,582,560,22
36081027101,4027101,5454,5428,26,0,1025,1861,207,56,3231,28,71,1837,1765,72
36081027102,4027102,3112,3112,0,0,725,2263,188,27,596,17,21,914,898,16
36081027200,4027200,2065,2065,0,0,463,283,34,1259,195,138,156,615,591,24
36081027301,4027301,3673,3673,0,0,848,3175,75,18,342,55,8,997,945,52
36081027302,4027302,4765,4759,6,0,1020,3515,211,139,786,65,49,1563,1514,49
36081027400,4027400,1927,1927,0,0,374,273,10,1247,184,112,101,607,576,31
36081027500,4027500,6773,6773,0,0,1343,4895,539,92,1080,74,93,2250,2163,87
36081027600,4027600,1365,1365,0,0,340,320,9,781,81,98,76,425,385,40
36081027701,4027701,3448,3435,13,0,673,2615,195,29,534,42,33,1082,1049,33
36081027702,4027702,5196,5196,0,0,997,3219,587,123,1104,88,75,1898,1806,92
36081027800,4027800,2529,2416,113,0,576,462,39,1774,82,66,106,867,841,26
36081027900,4027900,6358,6206,152,0,1063,3941,973,106,1125,103,110,2403,2308,95
36081028000,4028000,1901,1901,0,0,471,249,5,1353,97,87,110,570,552,18
36081028100,4028100,5991,5991,0,0,958,3256,1391,114,1037,37,156,2495,2399,96
36081028200,4028200,1801,1801,0,0,372,194,24,1301,95,52,135,564,542,22
36081028300,4028300,7523,7517,6,0,1210,3889,1528,116,1759,72,159,3194,3066,128
36081028400,4028400,3766,3766,0,0,749,353,46,2855,149,110,253,1206,1143,63
36081028500,4028500,4858,4858,0,0,777,1787,1911,72,828,86,174,2259,2141,118
36081028700,4028700,6544,6542,2,0,1072,2496,1701,97,1941,84,225,2909,2776,133
36081028801,4028801,2940,2920,20,0,633,377,51,1861,267,151,233,878,844,34
36081028802,4028802,1952,1952,0,0,446,283,14,1341,61,83,170,638,585,53
36081028803,4028803,8,8,0,0,4,1,0,6,0,0,1,1,1,0
36081028900,4028900,5202,5181,21,0,835,1733,1044,65,2152,62,146,2177,2085,92
36081029100,4029100,7341,7045,296,243,1340,1789,889,110,4331,94,128,2583,2463,120
36081029300,4029300,1457,1457,0,0,283,348,119,6,937,21,26,451,430,21
36081029400,4029400,8072,7337,735,0,1754,1106,139,5920,271,216,420,2578,2457,121
36081029500,4029500,3826,3826,0,0,576,888,1419,129,1173,79,138,1743,1685,58
36081029700,4029700,2258,2258,0,0,391,660,762,29,733,15,59,824,792,32
36081029900,4029900,5,5,0,0,2,3,0,0,0,0,2,2,1,1
36081030600,4030600,5287,4876,411,35,1061,529,109,3855,328,167,299,1563,1518,45
36081030903,4030903,6748,6748,0,0,1319,3206,720,32,2627,83,80,2163,2039,124
36081030904,4030904,3724,3710,14,0,693,1784,826,50,956,56,52,1341,1262,79
36081030905,4030905,3424,3412,12,0,697,1260,717,38,1307,25,77,1234,1153,81
36081030906,4030906,4924,4913,11,0,984,1683,686,48,2391,43,73,1675,1604,71
36081031700,4031700,6781,6415,366,0,1398,1509,4259,322,452,94,145,2812,2613,199
36081032000,4032000,5200,4343,857,214,1302,633,165,3864,114,146,278,1392,1323,69
36081032700,4032700,3932,3932,0,0,773,2599,388,75,810,39,21,1261,1175,86
36081032800,4032800,2660,2638,22,0,553,216,59,2152,26,82,125,885,846,39
36081032900,4032900,4251,4065,186,0,855,2406,441,231,1030,88,55,1251,1191,60
36081033000,4033000,7365,7354,11,0,1586,751,109,5705,203,167,430,2282,2182,100
36081033100,4033100,0,0,0,0,0,0,0,0,0,0,0,0,0,0
36081033401,4033401,4196,4196,0,0,993,515,41,3264,108,79,189,1450,1374,76
36081033403,4033403,4874,4874,0,0,722,178,17,4430,23,51,175,2363,2331,32
36081033404,4033404,4723,4723,0,0,722,223,34,4215,33,47,171,2354,2325,29
36081033405,4033405,3653,3653,0,0,628,212,13,3117,61,78,172,1610,1572,38
36081033700,4033700,3765,3765,0,0,717,2596,187,30,878,36,38,1125,1070,55
36081033900,4033900,3481,3481,0,0,642,2141,325,83,825,55,52,1220,1147,73
36081034700,4034700,3688,3579,109,0,778,2338,241,341,645,65,58,1101,1043,58
36081035100,4035100,4178,4178,0,0,770,2691,413,165,768,56,85,1599,1535,64
36081035200,4035200,2550,2508,42,10,492,238,14,2048,71,49,130,808,765,43
36081035300,4035300,2828,2828,0,0,637,2103,85,297,268,48,27,860,807,53
36081035700,4035700,5593,4775,818,330,1137,2796,514,1340,748,60,135,1580,1441,139
36081035800,4035800,4508,4498,10,7,950,360,40,3719,42,95,252,1465,1386,79
36081036100,4036100,2706,2699,7,0,609,1890,103,412,224,50,27,867,796,71
36081036300,4036300,2462,2462,0,0,655,1824,86,319,173,29,31,736,661,75
36081036500,4036500,4142,4142,0,0,1118,3414,39,429,168,44,48,1143,1070,73
36081036600,4036600,3003,2998,5,0,570,327,27,2347,96,48,158,1047,1001,46
36081036700,4036700,3099,3093,6,6,620,1688,93,772,429,50,67,939,869,70
36081036800,4036800,2513,2513,0,0,537,253,9,2020,44,58,129,838,795,43
36081037100,4037100,1917,1904,13,0,398,992,106,486,238,57,38,593,562,31
36081037300,4037300,2887,2887,0,0,684,2179,50,354,229,28,47,870,791,79
36081037501,4037501,1479,1479,0,0,401,1231,24,10,187,12,15,408,400,8
36081037502,4037502,2778,2778,0,0,605,2445,64,82,125,49,13,766,730,36
36081037600,4037600,6373,6356,17,0,1252,541,64,5175,184,147,262,2098,2003,95
36081037700,4037700,4493,4479,14,0,1202,3937,51,334,123,16,32,1129,1066,63
36081037900,4037900,6504,6489,15,0,1743,5827,72,237,234,70,64,1705,1615,90
36081038100,4038100,6966,6941,25,0,1797,5540,90,771,416,77,72,2051,1895,156
36081038301,4038301,2,0,2,0,1,0,0,1,1,0,0,0,0,0
36081038302,4038302,44,31,13,0,12,17,3,13,3,3,5,7,7,0
36081038400,4038400,2720,2692,28,0,489,174,22,2295,56,60,113,899,870,29
36081039400,4039400,3332,3332,0,0,648,359,36,2652,64,58,163,1093,1049,44
36081039800,4039800,1688,1688,0,0,336,180,22,1344,28,25,89,527,504,23
36081039901,4039901,2875,2563,312,0,678,2273,61,223,278,23,17,644,618,26
36081039902,4039902,2285,1933,352,0,641,1568,86,297,278,39,17,573,554,19
36081040000,4040000,1474,1474,0,0,266,160,7,1101,23,48,135,462,426,36
36081040101,4040101,2847,2847,0,0,680,2374,44,21,374,25,9,761,720,41
36081040102,4040102,4808,4808,0,0,1297,4175,22,88,448,47,28,1297,1234,63
36081040200,4040200,1474,1474,0,0,280,100,9,1160,77,20,108,461,439,22
36081040301,4040301,2768,2768,0,0,749,2396,42,15,288,20,7,748,725,23
36081040302,4040302,4760,4760,0,0,1242,4171,58,54,423,25,29,1212,1171,41
36081040400,4040400,4270,4270,0,0,864,458,58,3063,314,134,243,1370,1327,43
36081040501,4040501,1183,1171,12,0,316,1051,48,9,56,8,11,332,314,18
36081040502,4040502,2175,2175,0,0,543,1943,35,55,100,25,17,586,566,20
36081040701,4040701,3162,3162,0,0,860,2844,36,8,205,35,34,863,840,23
36081040702,4040702,5131,5131,0,0,1326,4680,28,106,241,52,24,1329,1272,57
36081040901,4040901,1951,1951,0,0,472,1600,38,0,247,50,16,549,516,33
36081040902,4040902,3534,3534,0,0,926,3205,53,77,154,28,17,896,852,44
36081041100,4041100,4532,4532,0,0,1096,3649,74,12,740,36,21,1228,1158,70
36081041300,4041300,4752,4752,0,0,1251,3953,154,32,562,29,22,1331,1257,74
36081041400,4041400,4526,4526,0,0,1046,824,39,2760,506,159,238,1483,1392,91
36081041500,4041500,4365,4348,17,0,1169,3587,195,70,422,59,32,1272,1215,57
36081042400,4042400,2295,2295,0,0,401,196,19,1885,55,41,99,789,754,35
36081042600,4042600,364,15,349,333,7,44,121,190,2,1,6,4,0,4
36081042700,4042700,4998,4998,0,0,1237,3999,226,55,647,42,29,1416,1355,61
36081043200,4043200,1280,1262,18,5,251,151,26,926,63,37,77,434,405,29
36081043400,4043400,1717,1704,13,0,327,196,13,1210,152,60,86,567,529,38
36081043701,4043701,3683,3152,531,531,768,2616,451,242,281,53,40,960,917,43
36081043702,4043702,6998,6998,0,0,1617,4578,425,515,1319,94,67,2370,2273,97
36081043900,4043900,4931,4931,0,0,1349,4296,167,44,371,27,26,1385,1325,60
36081044000,4044000,4783,4775,8,0,1128,827,51,2324,907,366,308,1426,1365,61
36081044301,4044301,4725,4714,11,0,1087,3378,202,336,698,55,56,1721,1645,76
36081044302,4044302,5373,5345,28,0,1158,2533,136,490,2096,55,63,1604,1539,65
36081044400,4044400,4562,4245,317,0,1202,1687,127,924,1278,296,250,1308,1237,71
36081044601,4044601,4013,3564,449,20,789,1763,119,1113,810,101,107,1378,1332,46
36081044602,4044602,5472,5108,364,0,1282,1481,188,1172,2366,146,119,1626,1580,46
36081044800,4044800,3063,3063,0,0,681,574,204,321,1798,71,95,915,872,43
36081045000,4045000,2070,2070,0,0,413,504,314,84,1033,66,69,641,599,42
36081045200,4045200,1209,883,326,322,228,139,240,135,650,13,32,235,228,7
36081045400,4045400,5207,5179,28,0,1102,468,204,496,3727,144,168,1686,1607,79
36081045500,4045500,13200,13188,12,0,2838,5172,1558,3990,1790,178,512,4624,4510,114
36081045600,4045600,1365,1365,0,0,278,148,101,76,969,12,59,410,384,26
36081045700,4045700,3536,3536,0,0,566,891,184,40,2325,35,61,1256,1185,71
36081045800,4045800,2271,2271,0,0,523,299,142,226,1465,70,69,728,693,35
36081045900,4045900,4150,4139,11,0,822,1556,174,22,2299,69,30,1288,1210,78
36081046000,4046000,6193,6189,4,0,1484,1935,96,793,2914,256,199,2042,1968,74
36081046100,4046100,2903,2903,0,0,623,1570,76,36,1166,15,40,877,816,61
36081046200,4046200,8206,7767,439,294,1845,2389,231,1254,3439,471,422,2428,2351,77
36081046300,4046300,4541,4541,0,0,1118,2925,87,37,1408,55,29,1253,1192,61
36081046400,4046400,1841,1559,282,0,293,341,344,451,595,37,73,558,526,32
36081046500,4046500,4276,4276,0,0,963,3519,93,14,551,63,36,1139,1092,47
36081046600,4046600,3676,3618,58,0,684,549,411,898,1633,74,111,1557,1489,68
36081046700,4046700,7281,7257,24,0,1497,4495,227,97,2326,59,77,2234,2180,54
36081046800,4046800,4173,4157,16,0,846,858,148,400,1964,475,328,1351,1205,146
36081046901,4046901,4346,4346,0,0,828,1916,167,40,2124,37,62,1463,1417,46
36081046902,4046902,4102,4102,0,0,745,2681,99,78,1163,21,60,1306,1271,35
36081047000,4047000,3343,3324,19,0,607,759,54,326,1448,469,287,958,910,48
36081047100,4047100,4785,4758,27,0,970,1310,163,47,3134,50,81,1537,1492,45
36081047200,4047200,3861,3617,244,226,649,646,564,893,1413,163,182,1383,1328,55
36081047300,4047300,4863,4839,24,0,789,956,405,69,3313,36,84,1941,1847,94
36081047500,4047500,5489,5457,32,0,966,1442,344,59,3544,31,69,1958,1828,130
36081047600,4047600,1374,1366,8,0,296,107,576,180,401,48,62,455,436,19
36081047801,4047801,4065,4044,21,0,595,857,591,1234,951,248,184,1820,1773,47
36081047802,4047802,1511,1511,0,0,259,248,48,275,658,168,114,467,454,13
36081047900,4047900,6837,6349,488,0,1374,1472,497,356,4379,33,100,2097,1980,117
36081048000,4048000,2666,2654,12,0,514,499,102,423,1101,351,190,746,722,24
36081048100,4048100,6321,6054,267,267,1145,2057,273,144,3721,50,76,1956,1893,63
36081048200,4048200,1518,1447,71,49,271,243,57,419,533,163,103,438,419,19
36081048301,4048301,2145,2145,0,0,358,398,150,18,1500,25,54,749,716,33
36081048302,4048302,2092,2092,0,0,398,701,213,19,1100,34,25,694,648,46
36081048400,4048400,5569,5119,450,0,1267,878,131,1588,1652,791,529,1559,1482,77
36081048500,4048500,5331,5207,124,0,943,852,293,137,3926,35,88,1889,1741,148
36081048900,4048900,1937,1753,184,0,470,690,247,135,826,5,34,520,487,33
36081049201,4049201,2888,2888,0,0,511,537,150,1618,359,113,111,1314,1295,19
36081049202,4049202,2018,2018,0,0,343,253,95,493,768,276,133,590,577,13
36081049301,4049301,2391,2391,0,0,501,662,727,19,929,19,35,838,773,65
36081049302,4049302,3498,3343,155,155,761,1391,1158,41,838,22,48,1133,1080,53
36081049500,4049500,1430,1416,14,0,301,494,688,21,185,5,37,557,522,35
36081049600,4049600,3251,3251,0,0,583,478,81,919,867,600,306,945,921,24
36081049700,4049700,3381,3365,16,0,684,791,933,39,1542,42,34,1145,1072,73
36081049900,4049900,5477,5473,4,0,1025,1286,716,37,3361,21,56,1871,1733,138
36081050000,4050000,4778,4421,357,276,1013,751,166,2858,526,272,205,1663,1578,85
36081050201,4050201,1678,1678,0,0,403,273,32,1057,169,69,78,461,448,13
36081050202,4050202,1521,1521,0,0,348,177,36,864,257,94,93,437,420,17
36081050400,4050400,1872,1848,24,0,367,209,26,1345,121,64,107,550,543,7
36081050500,4050500,1768,1768,0,0,314,493,476,58,698,21,22,701,661,40
36081050600,4050600,1635,1635,0,0,257,196,33,1056,139,85,126,495,478,17
36081050700,4050700,3699,3699,0,0,685,693,1710,44,1151,29,72,1434,1363,71
36081050800,4050800,2084,2083,1,0,397,207,38,1493,139,99,108,729,697,32
36081051000,4051000,1616,1616,0,0,286,199,15,1029,252,66,55,498,477,21
36081051100,4051100,2494,2494,0,0,484,783,1172,28,440,27,44,913,860,53
36081051200,4051200,2748,2735,13,0,572,384,41,1933,196,76,118,774,729,45
36081051300,4051300,2638,2638,0,0,594,719,999,64,799,29,28,919,874,45
36081051500,4051500,3126,3123,3,0,598,771,1802,30,459,13,51,1266,1189,77
36081051600,4051600,2069,2069,0,0,437,254,14,1551,138,32,80,628,603,25
36081051700,4051700,2146,2140,6,0,366,550,1318,35,196,27,20,893,822,71
36081051800,4051800,1948,1947,1,0,397,209,13,1562,26,46,92,645,620,25
36081052000,4052000,1593,1570,23,5,283,121,10,1262,29,44,127,501,487,14
36081052100,4052100,2197,2185,12,0,497,741,1208,42,163,14,29,806,770,36
36081052200,4052200,1605,1598,7,0,317,123,22,1302,37,36,85,528,500,28
36081052400,4052400,1945,1945,0,0,379,179,16,1536,61,44,109,590,559,31
36081052500,4052500,2252,2252,0,0,441,821,1096,32,229,32,42,812,775,37
36081052600,4052600,1958,1958,0,0,429,164,16,1524,79,73,102,610,563,47
36081052800,4052800,1563,1563,0,0,301,143,17,1259,37,20,87,551,521,30
36081053000,4053000,2393,2393,0,0,441,202,16,1974,43,26,132,742,719,23
36081053100,4053100,3462,3454,8,0,678,1346,1786,66,159,58,47,1391,1277,114
36081053200,4053200,1886,1873,13,0,334,155,34,1484,102,19,92,605,584,21
36081053401,4053401,2104,2104,0,0,408,215,15,1674,41,61,98,656,637,19
36081053501,4053501,1058,1058,0,0,176,667,336,18,10,12,15,450,424,26
36081053502,4053502,0,0,0,0,0,0,0,0,0,0,0,0,0,0
36081053601,4053601,1578,1578,0,0,276,167,13,1160,107,53,78,482,465,17
36081053800,4053800,1648,1648,0,0,310,187,14,1249,75,27,96,495,462,33
36081053901,4053901,3968,3954,14,0,684,1881,1174,104,680,38,91,1501,1422,79
36081053902,4053902,88,88,0,0,19,19,48,2,12,1,6,35,34,1
36081054000,4054000,4632,4624,8,0,981,722,96,2783,547,198,286,1368,1287,81
36081054200,4054200,5149,5144,5,5,889,959,233,1139,1549,747,522,1533,1475,58
36081054500,4054500,3648,3648,0,0,688,2228,904,91,288,55,82,1386,1326,60
36081054700,4054700,4166,4166,0,0,812,2414,975,174,477,54,72,1465,1353,112
36081054800,4054800,2336,2336,0,0,428,303,74,407,1096,329,127,663,630,33
36081054900,4054900,4932,4932,0,0,1011,2759,1239,156,543,72,163,1758,1678,80
36081055100,4055100,4574,4563,11,0,801,1844,1869,156,515,42,148,1847,1750,97
36081055200,4055200,3174,3144,30,30,531,732,179,767,1094,219,183,1089,1058,31
36081055300,4055300,2856,2856,0,0,446,1399,658,195,476,42,86,1101,1038,63
36081055400,4055400,2487,2487,0,0,443,500,239,418,1137,77,116,786,770,16
36081055500,4055500,1935,1921,14,14,353,1224,324,115,182,37,53,706,663,43
36081055600,4055600,2242,2242,0,0,363,473,160,268,989,210,142,671,652,19
36081055700,4055700,3966,3966,0,0,769,2149,1165,128,418,36,70,1453,1372,81
36081055800,4055800,1710,1710,0,0,286,412,146,284,549,210,109,519,502,17
36081055900,4055900,1178,1178,0,0,231,717,210,77,101,29,44,445,414,31
36081056000,4056000,1743,1724,19,0,329,464,204,197,715,92,71,521,507,14
36081056100,4056100,20,20,0,0,6,5,10,0,0,1,4,7,7,0
36081056200,4056200,1460,1460,0,0,257,472,172,235,420,96,65,449,438,11
36081056400,4056400,1559,1547,12,0,283,490,189,237,418,117,108,590,483,107
36081056500,4056500,1681,1672,9,0,385,1298,219,71,48,14,31,559,522,37
36081056600,4056600,1581,1565,16,0,309,367,124,330,462,158,140,479,455,24
36081056700,4056700,4751,4751,0,0,910,2687,1671,75,194,53,71,1703,1622,81
36081056800,4056800,4862,4762,100,6,876,924,216,2818,517,184,203,1610,1515,95
36081057700,4057700,4023,4023,0,0,847,1911,1799,115,129,24,45,1547,1463,84
36081057900,4057900,1743,1743,0,0,357,836,796,15,52,22,22,672,643,29
36081058000,4058000,3589,3572,17,0,631,431,60,2591,214,125,168,1148,1117,31
36081058100,4058100,2785,2785,0,0,467,1073,1424,84,144,10,50,1129,1078,51
36081058200,4058200,4509,4479,30,22,864,613,106,3143,213,142,292,1412,1357,55
36081058300,4058300,3362,3362,0,0,533,1171,1755,104,197,25,110,1452,1333,119
36081058500,4058500,4128,4102,26,0,708,1546,2041,64,382,21,74,1660,1519,141
36081058700,4058700,3336,3336,0,0,607,890,2015,70,272,38,51,1407,1323,84
36081058900,4058900,4308,4305,3,0,851,1748,2202,78,117,58,105,1706,1601,105
36081059000,4059000,1182,1182,0,0,208,105,20,962,14,30,51,387,378,9
36081059100,4059100,5226,5226,0,0,970,2624,2014,134,249,59,146,2102,1949,153
36081059200,4059200,1186,1186,0,0,168,65,30,1010,15,11,55,389,383,6
36081059300,4059300,4092,4092,0,0,678,1041,2563,78,273,36,101,1755,1619,136
36081059400,4059400,1506,1506,0,0,229,108,42,1238,14,23,81,522,509,13
36081059501,4059501,2091,2091,0,0,362,708,1099,34,202,19,29,892,821,71
36081059502,4059502,2712,2702,10,0,524,1473,996,75,110,24,34,995,925,70
36081059600,4059600,1373,1373,0,0,247,83,26,1172,13,21,58,474,458,16
36081059800,4059800,1764,1759,5,0,310,102,27,1480,42,21,92,599,585,14
36081059900,4059900,1594,1584,10,0,292,448,904,30,177,9,26,614,587,27
36081060000,4060000,1223,1223,0,0,208,90,19,1039,7,16,52,399,399,0
36081060100,4060100,2414,2414,0,0,531,839,1268,33,194,41,39,882,844,38
36081060300,4060300,1854,1854,0,0,331,651,1044,23,92,14,30,752,699,53
36081060600,4060600,1328,1328,0,0,238,89,18,1125,25,14,57,465,453,12
36081060701,4060701,3,3,0,0,1,0,3,0,0,0,0,2,1,1
36081060800,4060800,1475,1475,0,0,239,73,11,1272,35,23,61,484,467,17
36081061000,4061000,1204,1204,0,0,197,63,6,1073,1,23,38,421,392,29
36081061200,4061200,1552,1552,0,0,233,76,13,1355,23,16,69,498,478,20
36081061301,4061301,5763,5759,4,0,985,1825,3164,119,479,60,116,2214,2118,96
36081061302,4061302,0,0,0,0,0,0,0,0,0,0,0,0,0,0
36081061400,4061400,1205,1205,0,0,205,88,22,1031,6,5,53,393,372,21
36081061601,4061601,2095,2095,0,0,327,116,11,1830,14,32,92,709,689,20
36081061602,4061602,1402,1402,0,0,256,143,29,1068,27,50,85,409,401,8
36081061800,4061800,1736,1736,0,0,286,110,31,1447,31,24,93,742,709,33
36081061900,4061900,3097,3097,0,0,589,862,1912,75,163,26,59,1273,1199,74
36081062000,4062000,1419,1412,7,0,206,120,22,1184,0,17,76,500,492,8
36081062100,4062100,3151,3059,92,0,617,1145,1689,90,128,31,68,1158,1113,45
36081062200,4062200,1979,1979,0,0,255,147,23,1690,23,28,68,676,654,22
36081062300,4062300,1923,1923,0,0,350,672,1087,50,61,20,33,831,787,44
36081062400,4062400,0,0,0,0,0,0,0,0,0,0,0,1,1,0
36081062500,4062500,2625,2619,6,0,494,916,1529,41,74,32,33,1050,988,62
36081062600,4062600,2689,2679,10,0,543,244,39,2229,31,43,103,896,851,45
36081062700,4062700,3010,3001,9,0,647,1125,1604,52,155,13,61,1135,1059,76
36081062900,4062900,3042,3028,14,0,600,1231,1565,63,86,28,69,1206,1120,86
36081063000,4063000,1602,1587,15,0,263,106,19,1353,4,10,110,536,518,18
36081063200,4063200,2261,2261,0,0,436,144,46,1932,17,30,92,683,666,17
36081063301,4063301,1587,1587,0,0,325,405,1039,20,78,14,31,634,592,42
36081063302,4063302,1665,1665,0,0,330,447,1086,30,81,4,17,665,603,62
36081063500,4063500,2784,2775,9,0,525,906,1689,31,77,24,57,1095,1038,57
36081063700,4063700,3507,3298,209,0,628,830,2145,148,289,17,78,1281,1188,93
36081063800,4063800,3584,3540,44,0,669,454,159,2570,110,82,209,1066,1033,33
36081063900,4063900,2794,2782,12,0,467,845,1496,111,263,22,57,1178,1095,83
36081064101,4064101,2378,2378,0,0,418,569,1503,34,209,24,39,1049,1002,47
36081064102,4064102,4,3,1,0,2,3,1,0,0,0,0,1,0,1
36081064500,4064500,2064,2047,17,0,362,448,843,40,648,35,50,829,773,56
36081064600,4064600,3025,3025,0,0,532,218,37,2539,39,40,152,1007,966,41
36081065000,4065000,2831,2831,0,0,559,175,29,2410,22,38,157,898,862,36
36081065401,4065401,2836,2836,0,0,592,323,113,2137,71,47,145,981,892,89
36081065402,4065402,5,5,0,0,3,2,0,0,0,1,2,1,1,0
36081065501,4065501,3,3,0,0,0,2,0,0,0,0,1,1,1,0
36081065600,4065600,5423,5419,4,0,1040,545,136,4236,158,114,234,1737,1638,99
36081065702,4065702,1775,1775,0,0,341,418,1241,9,67,8,32,808,749,59
36081065703,4065703,2829,2817,12,0,550,440,2170,16,127,19,57,1154,1078,76
36081065900,4065900,1850,1850,0,0,371,169,1509,1,140,10,21,800,729,71
36081066000,4066000,3511,3511,0,0,648,351,143,2689,90,54,184,1118,1070,48
36081066100,4066100,1573,1573,0,0,264,203,1252,5,86,2,25,677,634,43
36081066301,4066301,2713,2713,0,0,511,365,1714,17,537,18,62,1009,947,62
36081066302,4066302,4,4,0,0,1,4,0,0,0,0,0,1,0,1
36081066401,4066401,1923,1708,215,0,324,284,99,1364,31,37,108,574,537,37
36081066402,4066402,3942,3932,10,0,762,328,148,3075,57,82,252,1271,1211,60
36081066403,4066403,4480,4473,7,0,884,495,103,3567,95,90,130,1553,1460,93
36081066404,4066404,0,0,0,0,0,0,0,0,0,0,0,0,0,0
36081066501,4066501,3538,3534,4,0,613,508,2713,32,188,22,75,1559,1450,109
36081066701,4066701,2789,2789,0,0,544,542,1957,3,231,12,44,1163,1068,95
36081066900,4066900,1790,1790,0,0,344,261,1329,3,161,9,27,766,713,53
36081067100,4067100,2248,2248,0,0,389,230,1439,3,535,7,34,890,852,38
36081067700,4067700,1832,1832,0,0,314,196,1365,0,223,13,35,760,713,47
36081067900,4067900,4397,3948,449,265,691,1464,1780,195,770,35,153,1838,1648,190
36081068000,4068000,5220,5214,6,0,1021,480,74,4259,85,71,251,1701,1637,64
36081068200,4068200,1262,1259,3,0,255,130,17,1047,8,15,45,424,407,17
36081068300,4068300,4052,4045,7,0,552,1446,315,136,2054,28,73,1624,1562,62
36081068700,4068700,4597,4597,0,0,700,1051,1290,78,1977,65,136,1924,1861,63
36081069000,4069000,3787,3781,6,0,792,292,33,3201,39,65,157,1211,1155,56
36081069300,4069300,2887,2887,0,0,505,793,928,89,905,55,117,1304,1234,70
36081069400,4069400,3604,3592,12,0,768,325,48,2985,47,79,120,1181,1108,73
36081069500,4069500,2451,2451,0,0,459,504,977,34,825,20,91,988,920,68
36081069701,4069701,4435,4435,0,0,838,874,1498,199,1506,79,279,2015,1900,115
36081069702,4069702,3929,3918,11,0,706,620,1542,29,1570,42,126,1544,1439,105
36081070300,4070300,2225,2225,0,0,396,589,892,43,611,24,66,903,854,49
36081070700,4070700,2426,2426,0,0,463,317,1167,10,806,24,102,993,961,32
36081070900,4070900,2635,2635,0,0,512,344,1063,63,1036,21,108,1124,1059,65
36081071100,4071100,5687,5590,97,87,846,942,2527,181,1740,83,214,2943,2771,172
36081071303,4071303,5307,5307,0,0,945,927,2862,113,1142,52,211,2772,2599,173
36081071304,4071304,6386,6386,0,0,1067,718,3448,134,1616,103,367,3250,3088,162
36081071305,4071305,5126,5126,0,0,820,727,2431,252,1438,57,221,2554,2388,166
36081071306,4071306,6181,6181,0,0,1059,1212,2470,252,1809,115,323,3000,2826,174
36081071600,4071600,2,2,0,0,0,0,0,1,0,0,1,2,2,0
36081071701,4071701,5557,5548,9,0,831,887,2429,172,1741,80,248,2812,2625,187
36081071702,4071702,4660,4656,4,0,651,729,1451,210,1977,97,196,2277,2196,81
36081071900,4071900,2887,2875,12,0,641,659,979,87,864,47,251,1088,1031,57
36081072100,4072100,5040,5040,0,0,882,736,2399,111,1471,80,243,2327,2205,122
36081072300,4072300,2158,2158,0,0,434,184,1047,25,782,21,99,858,799,59
36081072900,4072900,1490,1480,10,0,334,272,576,31,505,28,78,536,515,21
36081073100,4073100,1550,1550,0,0,339,173,784,32,483,6,72,613,577,36
36081073700,4073700,2277,2265,12,0,345,266,1183,48,649,27,104,1299,1184,115
36081073900,4073900,5548,5425,123,123,989,631,3000,131,1524,54,208,2826,2664,162
36081074100,4074100,3164,3164,0,0,488,360,1633,66,938,43,124,1631,1576,55
36081074300,4074300,4433,4281,152,0,827,755,2150,80,1166,64,218,1907,1809,98
36081074500,4074500,3659,3659,0,0,708,798,1693,276,620,64,208,1602,1520,82
36081074700,4074700,3539,3520,19,0,681,761,947,135,1496,63,137,1441,1361,80
36081074900,4074900,1563,1563,0,0,338,153,853,13,449,25,70,606,567,39
36081075701,4075701,5110,5110,0,0,796,712,2161,157,1852,45,183,2780,2586,194
36081075702,4075702,5071,4822,249,175,905,487,2502,151,1677,43,211,2403,2255,148
36081076901,4076901,4274,4264,10,0,692,675,2278,130,953,44,194,2284,2164,120
36081076902,4076902,1390,1382,8,0,245,290,576,70,365,17,72,687,650,37
36081077300,4077300,2311,2311,0,0,340,489,1091,105,506,16,104,1183,1109,74
36081077500,4077500,2241,2231,10,0,303,444,1181,113,356,52,95,1103,1037,66
36081077902,4077902,5416,5416,0,0,1597,335,4182,114,604,65,116,1857,1745,112
36081077903,4077903,2937,2918,19,0,576,700,1189,115,836,33,64,1214,1165,49
36081077904,4077904,6324,6245,79,0,1436,944,3169,245,1664,104,198,2295,2216,79
36081077905,4077905,2586,2486,100,0,343,527,854,315,781,23,86,1288,1182,106
36081077906,4077906,3968,3958,10,0,886,411,1820,87,1508,48,94,1579,1503,76
36081077907,4077907,3349,3154,195,0,993,403,2266,228,261,73,118,1097,1037,60
36081077908,4077908,3838,3709,129,4,940,827,811,698,1229,66,207,1458,1339,119
36081078800,4078800,2002,2002,0,0,393,340,31,1062,206,165,198,633,594,39
36081079000,4079000,2875,2856,19,0,602,466,52,1437,427,248,245,905,868,37
36081079200,4079200,2717,2473,244,0,508,365,39,1487,295,281,250,806,762,44
36081079300,4079300,1,1,0,0,0,0,0,0,0,0,1,1,0,1
36081079701,4079701,7620,7607,13,0,1346,450,364,268,6338,69,131,3054,2960,94
36081079702,4079702,5002,5002,0,0,851,568,151,66,4167,22,28,1830,1728,102
36081079900,4079900,3871,3853,18,18,690,635,294,23,2863,37,19,1290,1210,80
36081080301,4080301,4828,4828,0,0,938,953,448,57,3284,45,41,1540,1462,78
36081080302,4080302,3973,3965,8,0,760,739,544,90,2506,32,62,1240,1182,58
36081080900,4080900,7591,7138,453,0,1437,1033,2952,445,2823,119,219,2926,2813,113
36081081400,4081400,4088,4078,10,0,867,714,86,1446,962,458,422,1153,1109,44
36081081800,4081800,3873,3853,20,0,796,695,133,1126,947,557,415,1180,1135,45
36081083700,4083700,6229,6224,5,0,1164,511,410,62,5155,30,61,1973,1860,113
36081083800,4083800,5194,5176,18,0,963,1170,537,663,1329,921,574,1707,1598,109
36081084000,4084000,6644,6640,4,0,1212,1373,381,1094,1716,1223,857,2140,2020,120
36081084500,4084500,5516,5516,0,0,874,948,274,452,3736,33,73,2179,2103,76
36081084601,4084601,3045,3029,16,0,529,662,357,321,825,570,310,1007,959,48
36081084602,4084602,1496,955,541,0,266,395,146,493,257,134,71,296,282,14
36081084901,4084901,3013,3013,0,0,471,434,50,86,2403,20,20,1202,1012,190
36081084902,4084902,4466,4466,0,0,666,562,78,141,3637,17,31,1747,1590,157
36081085300,4085300,5415,5414,1,0,693,395,173,52,4734,17,44,2274,2139,135
36081085500,4085500,6889,6889,0,0,1035,1244,385,155,4983,44,78,2722,2646,76
36081085700,4085700,5770,5474,296,191,860,1056,236,87,4287,49,55,2104,2002,102
36081085900,4085900,6162,6162,0,0,1051,724,301,84,4965,26,62,2283,2161,122
36081086100,4086100,2450,2450,0,0,348,259,160,22,1987,14,8,975,922,53
36081086300,4086300,7118,7110,8,0,1089,965,346,174,5536,46,51,2773,2668,105
36081086400,4086400,2867,2796,71,0,580,1098,320,266,675,289,219,889,837,52
36081086500,4086500,5224,5138,86,0,552,521,537,84,4009,11,62,2464,2281,183
36081086900,4086900,2343,2235,108,0,315,250,44,98,1914,9,28,971,858,113
36081087100,4087100,6373,6240,133,0,873,897,349,539,4435,41,112,3281,2810,471
36081088400,4088400,7578,7565,13,0,1324,1543,5255,131,415,82,152,3070,2833,237
36081088902,4088902,7015,7015,0,0,1060,1183,482,379,4872,36,63,2945,2822,123
36081088903,4088903,4487,4289,198,162,611,611,888,72,2837,30,49,1777,1713,64
36081089201,4089201,7404,7404,0,0,1296,816,6080,28,298,56,126,2663,2579,84
36081089202,4089202,0,0,0,0,0,0,0,0,0,0,0,0,0,0
36081090700,4090700,1584,1500,84,0,322,571,365,64,562,5,17,485,457,28
36081091602,4091602,12,12,0,0,8,1,6,5,0,0,0,4,1,3
36081091603,4091603,4456,4456,0,0,754,148,4213,1,13,26,55,2804,1896,908
36081091604,4091604,0,0,0,0,0,0,0,0,0,0,0,1,0,1
36081091800,4091800,12,12,0,0,1,0,11,0,0,1,0,9,9,0
36081091900,4091900,6417,5855,562,562,1182,2528,1070,241,2405,41,132,1910,1830,80
36081092200,4092200,2208,2208,0,0,483,107,2005,10,35,14,37,867,784,83
36081092500,4092500,4356,4351,5,0,1100,2336,613,75,1243,37,52,1424,1299,125
36081092800,4092800,3204,3204,0,0,701,170,2911,3,36,26,58,1246,1131,115
36081092900,4092900,7638,7626,12,0,1648,3481,1552,90,2356,52,107,2564,2434,130
36081093401,4093401,3732,3557,175,0,751,332,3224,47,43,29,57,1642,1484,158
36081093402,4093402,3704,3543,161,161,643,583,2657,215,122,38,89,1907,1608,299
36081093800,4093800,4460,3846,614,415,583,919,2621,642,100,59,119,2288,2020,268
36081093900,4093900,6268,6268,0,0,1298,2071,1100,79,2834,59,125,2174,2047,127
36081094201,4094201,3729,3548,181,175,744,1079,1013,1215,188,58,176,1532,1426,106
36081094202,4094202,4785,4723,62,0,1241,1398,874,1992,241,87,193,1925,1767,158
36081094203,4094203,5676,5659,17,0,782,1047,3017,1167,184,73,188,2850,2747,103
36081094500,4094500,4327,4317,10,0,832,1060,1879,75,1251,28,34,1552,1465,87
36081094700,4094700,3035,3035,0,0,709,1424,597,63,874,22,55,962,895,67
36081095400,4095400,6108,5887,221,200,1468,1409,752,3134,303,181,329,2276,2053,223
36081096400,4096400,6353,5832,521,244,1357,1216,713,3331,531,152,410,2153,2015,138
36081097202,4097202,3460,3451,9,0,1200,864,49,2373,10,44,120,1303,1271,32
36081097204,4097204,4078,3203,875,659,935,1042,292,2448,81,52,163,1316,1244,72
36081097205,4097205,4268,4268,0,0,1312,1641,71,2213,156,74,113,1468,1439,29
36081097206,4097206,2910,2910,0,0,879,775,43,1839,62,77,114,1101,1049,52
36081097207,4097207,12,12,0,0,7,7,0,1,0,0,4,3,3,0
36081097300,4097300,2007,2007,0,0,398,277,1448,9,223,24,26,762,735,27
36081098100,4098100,2353,2353,0,0,465,372,1317,30,582,26,26,866,806,60
36081098700,4098700,2543,2543,0,0,509,381,1502,15,592,19,34,985,927,58
36081099100,4099100,6642,6642,0,0,1010,831,4655,71,939,28,118,3091,2933,158
36081099200,4099200,4348,4186,162,102,1122,1229,261,2445,139,78,196,1575,1494,81
36081099701,4099701,3075,3075,0,0,570,384,1658,13,926,23,71,1333,1270,63
36081099703,4099703,3938,3938,0,0,506,410,2232,105,1078,33,80,2025,1871,154
36081099704,4099704,7280,7270,10,0,840,824,3978,142,2181,42,113,4119,3887,232
36081099705,4099705,2687,2687,0,0,434,392,1133,43,1048,26,45,1153,1117,36
36081099801,4099801,7853,7437,416,368,1832,2411,368,4230,293,167,384,2716,2574,142
36081099802,4099802,5822,5822,0,0,1213,1188,1221,2774,229,135,275,3078,2873,205
36081099900,4099900,0,0,0,0,0,0,0,0,0,0,0,0,0,0
36081100801,4100801,2496,2496,0,0,723,311,913,927,68,121,156,716,674,42
36081100803,4100803,4817,4462,355,0,1210,1754,310,2229,99,181,244,1451,1353,98
36081100804,4100804,4315,4315,0,0,1209,750,1152,1987,113,96,217,1298,1218,80
36081101002,4101002,4596,4596,0,0,1477,329,3258,800,22,88,99,1811,1697,114
36081101003,4101003,3943,3545,398,369,1211,1282,1123,1288,43,71,136,1190,1140,50
36081101004,4101004,6612,5828,784,628,1637,1467,2018,2652,199,122,154,2373,2293,80
36081101700,4101700,6307,6301,6,0,1125,727,3435,38,1984,21,102,2618,2515,103
36081102900,4102900,3786,3627,159,151,718,610,1957,59,1097,14,49,1462,1377,85
36081103201,4103201,6986,6986,0,0,2261,2659,188,3567,106,131,335,2135,2030,105
36081103202,4103202,6860,6523,337,87,2269,2213,2946,1319,90,135,157,1965,1879,86
36081103300,4103300,4459,4459,0,0,924,694,2295,3,1384,30,53,1644,1527,117
36081103900,4103900,6618,6618,0,0,1224,1236,2600,53,2613,29,87,2390,2261,129
36081104700,4104700,7907,7894,13,0,1385,1101,2250,39,4365,42,110,2997,2873,124
36081105900,4105900,3812,3811,1,0,684,318,1902,16,1509,19,48,1368,1319,49
36081107201,4107201,2370,2355,15,0,497,262,1959,18,47,39,45,977,883,94
36081107202,4107202,0,0,0,0,0,0,0,0,0,0,0,0,0,0
36081108500,4108500,2778,2762,16,0,536,398,1128,18,1183,13,38,1040,982,58
36081109300,4109300,3139,2994,145,121,550,238,1561,57,1199,12,72,1098,1051,47
36081109700,4109700,1797,1787,10,0,319,265,877,19,594,5,37,705,652,53
36081109900,4109900,3538,3520,18,0,698,486,1252,49,1682,21,48,1234,1193,41
36081111300,4111300,2611,2598,13,0,483,295,1070,30,1147,8,61,930,877,53
36081112300,4112300,2126,2112,14,0,341,390,754,30,879,15,58,914,889,25
36081112900,4112900,2248,2240,8,0,379,270,1055,39,815,15,54,950,898,52
36081113300,4113300,1554,1554,0,0,282,231,802,8,470,15,28,650,620,30
36081113900,4113900,3602,3590,12,0,603,735,1352,58,1361,18,78,1564,1454,110
36081114100,4114100,2580,2580,0,0,438,285,1194,15,1028,6,52,898,872,26
36081114700,4114700,1833,1833,0,0,332,207,755,3,826,12,30,656,641,15
36081115100,4115100,1087,1087,0,0,162,122,455,5,494,0,11,400,380,20
36081115500,4115500,2132,2132,0,0,423,618,363,30,1068,15,38,767,740,27
36081115700,4115700,3529,3529,0,0,495,442,400,22,2614,12,39,1389,1308,81
36081115900,4115900,3922,3878,44,0,612,604,488,79,2675,42,34,1478,1387,91
36081116100,4116100,4585,4139,446,446,596,607,316,136,3446,12,68,1674,1590,84
36081116301,4116301,5178,4614,564,564,754,1277,375,174,3277,18,57,1776,1626,150
36081116302,4116302,3461,3461,0,0,552,679,188,92,2431,23,48,1288,1250,38
36081116700,4116700,2094,2094,0,0,386,581,92,21,1357,12,31,756,702,54
36081117100,4117100,2837,2810,27,0,445,685,427,34,1649,13,29,1077,1031,46
36081117500,4117500,5410,5404,6,0,885,833,1249,99,3096,38,95,2111,2011,100
36081118100,4118100,2015,2015,0,0,326,286,632,31,1033,14,19,807,755,52
36081118500,4118500,2357,2357,0,0,429,674,245,28,1375,8,27,820,786,34
36081118700,4118700,2648,2632,16,0,462,569,204,70,1779,5,21,884,836,48
36081118900,4118900,2625,2625,0,0,475,382,211,20,1972,12,28,852,804,48
36081119100,4119100,3694,3694,0,0,708,1163,320,36,2144,7,24,1250,1177,73
36081119300,4119300,2407,2407,0,0,456,477,395,27,1468,8,32,837,799,38
36081119500,4119500,1445,1429,16,0,248,357,417,29,607,11,24,481,459,22
36081119900,4119900,1699,1682,17,0,232,247,226,11,1174,10,31,545,529,16
36081120100,4120100,1840,1827,13,0,344,261,102,18,1427,6,26,568,541,27
36081120300,4120300,1818,1803,15,0,288,196,142,16,1443,5,16,574,545,29
36081120500,4120500,3144,3075,69,4,500,240,125,32,2675,25,47,1146,1083,63
36081120701,4120701,3058,3043,15,0,506,573,681,34,1705,10,55,977,929,48
36081120702,4120702,3,3,0,0,1,1,0,0,2,0,0,1,0,1
36081121100,4121100,2,2,0,0,0,0,0,0,1,1,0,1,0,1
36081121500,4121500,4737,4737,0,0,945,976,485,85,3088,40,63,1515,1429,86
36081122300,4122300,3822,3822,0,0,794,556,964,54,2140,36,72,1280,1217,63
36081122702,4122702,6959,6959,0,0,1582,2017,870,2244,1484,97,247,2985,2894,91
36081122703,4122703,6801,6801,0,0,1343,2386,1879,863,1365,104,204,2788,2717,71
36081122704,4122704,4444,4433,11,0,899,874,964,364,2046,43,153,1707,1616,91
36081124100,4124100,4004,4004,0,0,775,519,1191,243,1862,63,126,1387,1311,76
36081124700,4124700,3734,3713,21,0,844,262,1665,58,1574,59,116,1228,1176,52
36081125700,4125700,3642,3480,162,81,714,870,368,446,1783,68,107,1202,1144,58
36081126500,4126500,1595,1572,23,0,210,262,376,99,786,41,31,609,564,45
36081126700,4126700,4490,2162,2328,7,389,788,1742,581,1161,39,179,747,674,73
36081127700,4127700,3600,3584,16,0,914,159,2579,152,528,67,115,1185,1104,81
36081128300,4128300,5,0,5,0,0,1,0,2,2,0,0,0,0,0
36081129102,4129102,3561,3553,8,0,720,319,1933,105,1041,48,115,1280,1229,51
36081129103,4129103,3811,3811,0,0,518,419,1912,121,1241,17,101,2082,1994,88
36081129104,4129104,4318,4316,2,0,662,615,1715,151,1649,50,138,2027,1959,68
36081130100,4130100,4203,4203,0,0,732,804,758,600,1678,188,175,1659,1608,51
36081133300,4133300,3915,3900,15,0,833,386,1719,70,1590,46,104,1415,1323,92
36081133900,4133900,1360,1351,9,0,327,89,672,13,520,14,52,443,416,27
36081134100,4134100,3659,3659,0,0,785,466,901,59,2134,35,64,1165,1118,47
36081134701,4134701,5561,5561,0,0,1102,746,840,704,3087,57,127,2230,2173,57
36081134702,4134702,5117,5100,17,0,1188,730,874,474,2848,44,147,1882,1843,39
36081136700,4136700,6250,6222,28,0,1096,497,1571,90,3955,37,100,2538,2444,94
36081137700,4137700,7309,7290,19,0,1527,862,1356,414,4443,59,175,2619,2531,88
36081138501,4138501,4994,4994,0,0,999,485,972,78,3375,35,49,1641,1579,62
36081138502,4138502,85,19,66,0,3,16,63,0,4,1,1,2,1,1
36081139900,4139900,1769,1760,9,0,294,121,553,18,1036,10,31,581,562,19
36081140300,4140300,2406,2406,0,0,424,206,631,33,1489,21,26,814,778,36
36081140901,4140901,1020,1016,4,0,184,105,254,25,602,6,28,323,314,9
36081140902,4140902,2906,2895,11,0,544,254,608,29,1947,16,52,937,907,30
36081141700,4141700,4975,4975,0,0,898,601,1069,70,3122,34,79,1627,1581,46
36081142900,4142900,3897,3897,0,0,682,440,1348,37,1991,18,63,1377,1311,66
36081143500,4143500,2364,2364,0,0,459,226,660,17,1416,2,43,792,746,46
36081144100,4144100,2957,2957,0,0,448,286,925,34,1656,6,50,1229,1185,44
36081144700,4144700,3131,3117,14,4,630,502,362,352,1835,18,62,1060,1001,59
36081145101,4145101,1501,1492,9,0,291,205,553,9,720,0,14,534,504,30
36081145102,4145102,2597,2597,0,0,501,393,527,87,1534,13,43,879,851,28
36081145900,4145900,2870,2870,0,0,482,450,994,25,1333,24,44,1021,968,53
36081146300,4146300,2929,2690,239,219,519,575,933,104,1242,35,40,1052,993,59
36081146700,4146700,2807,2801,6,0,366,460,1148,61,1051,17,70,1382,1323,59
36081147100,4147100,3239,3239,0,0,555,419,1140,38,1584,25,33,1390,1310,80
36081147900,4147900,4279,4279,0,0,755,570,1656,52,1854,23,124,1828,1728,100
36081148300,4148300,2968,2968,0,0,542,238,1639,20,963,17,91,1115,1053,62
36081150701,4150701,2919,2903,16,0,435,235,1524,23,1080,16,41,1121,1054,67
36081150702,4150702,3049,2940,109,89,475,345,1334,36,1281,5,48,1233,1154,79
36081152901,4152901,6382,6382,0,0,1090,633,1900,200,3464,51,134,2681,2559,122
36081152902,4152902,5665,5649,16,0,1003,467,2287,77,2712,30,92,2382,2290,92
36081155101,4155101,1945,1945,0,0,28,46,1808,16,43,5,27,1724,1499,225
36081155103,4155103,4373,4308,65,0,527,683,2041,400,1091,56,102,2359,2256,103
36081155104,4155104,3616,3079,537,525,508,488,1189,318,1375,77,169,1319,1252,67
36081156700,4156700,1470,844,626,451,178,187,168,378,683,11,43,287,279,8
36081157101,4157101,7561,7545,16,0,1220,821,1595,377,4336,225,207,2628,2519,109
36081157102,4157102,2109,2109,0,0,391,260,322,90,1321,72,44,618,586,32
36081157901,4157901,5184,5184,0,0,740,483,1386,121,2942,110,142,1846,1764,82
36081157902,4157902,3757,3698,59,52,581,325,758,149,2300,118,107,1123,1089,34
36081157903,4157903,4489,4475,14,0,824,526,1152,157,2439,103,112,1487,1416,71
36081161700,4161700,4541,4522,19,0,848,896,1494,240,1682,103,126,1547,1468,79
36081162100,4162100,6682,6670,12,0,1255,1438,1093,459,3242,225,225,2194,2075,119
36081990100,4990100,0,0,0,0,0,0,0,0,0,0,0,0,0,0
36085000300,5000300,2348,2232,116,0,393,509,953,343,402,32,109,1208,1131,77
36085000600,5000600,2859,2819,40,0,456,693,1459,222,402,37,46,1376,1315,61
36085000700,5000700,5143,5063,80,0,1180,1468,985,2167,227,71,225,2317,2164,153
36085000800,5000800,6268,6268,0,0,1390,1868,2404,261,1531,76,128,2096,1981,115
36085000900,5000900,2240,2240,0,0,560,784,376,774,170,37,99,908,802,106
36085001100,5001100,4234,4075,159,0,1098,1858,716,1293,194,46,127,1548,1343,205
36085001700,5001700,1865,1801,64,52,398,673,599,322,195,20,56,708,640,68
36085001800,5001800,495,433,62,0,144,154,238,40,15,9,39,225,157,68
36085002001,5002001,2524,2511,13,0,408,452,1525,74,405,17,51,1061,1004,57
36085002002,5002002,3302,3266,36,8,614,431,2166,106,494,20,85,1317,1213,104
36085002100,5002100,5467,5297,170,0,1197,2062,1236,1466,476,67,160,2336,2100,236
36085002700,5002700,2049,1402,647,613,415,924,374,566,89,21,75,541,487,54
36085002900,5002900,6871,6862,9,0,2123,2825,417,2837,494,76,222,2302,2098,204
36085003300,5003300,3738,3728,10,0,796,997,1408,789,348,36,160,1508,1410,98
36085003600,5003600,2792,2792,0,0,669,761,1011,155,768,33,64,917,871,46
36085003900,5003900,2179,2089,90,0,335,521,971,466,116,25,80,1079,1033,46
36085004001,5004001,2775,2752,23,0,653,879,380,840,574,34,68,914,886,28
36085004002,5004002,3409,3409,0,0,686,825,153,840,1520,27,44,1034,1006,28
36085004003,5004003,4851,4851,0,0,1535,1116,92,3302,163,43,135,1827,1795,32
36085004004,5004004,2807,2781,26,11,671,824,344,699,838,15,87,946,904,42
36085004700,5004700,3126,2622,504,0,464,525,1803,286,409,37,66,1216,1107,109
36085005000,5005000,4357,4338,19,0,921,650,2274,201,1138,35,59,1578,1495,83
36085005901,5005901,2854,2843,11,0,532,372,2004,126,259,13,80,1225,1163,62
36085005902,5005902,5,5,0,0,5,2,0,1,1,0,1,1,0,1
36085006400,5006400,3698,3633,65,0,762,792,1828,388,569,33,88,1359,1288,71
36085006700,5006700,2927,2799,128,0,590,460,2007,157,173,14,116,1187,1141,46
36085007001,5007001,2634,2625,9,0,478,423,1697,32,422,10,50,978,938,40
36085007002,5007002,6215,5877,338,216,1220,1030,3611,228,1203,32,111,1970,1867,103
36085007400,5007400,4962,4951,11,0,1023,985,2538,228,1070,32,109,1830,1732,98
36085007500,5007500,4200,3640,560,540,955,1534,1346,850,336,48,86,1300,1216,84
36085007700,5007700,1762,1747,15,0,534,776,178,667,66,21,54,599,541,58
36085008100,5008100,4822,4343,479,473,950,1654,1186,1317,412,71,182,1850,1751,99
36085009601,5009601,4075,3818,257,0,588,425,2816,89,666,9,70,1573,1508,65
36085009602,5009602,3767,3746,21,0,731,546,2526,86,518,22,69,1496,1408,88
36085009701,5009701,4454,4447,7,0,1138,1218,1433,1318,281,56,148,1614,1529,85
36085009702,5009702,8,7,1,0,1,1,7,0,0,0,0,3,3,0
36085010500,5010500,5597,5545,52,0,1352,2002,1952,914,526,63,140,1940,1816,124
36085011201,5011201,5768,5763,5,0,1106,663,3755,75,1125,72,78,2043,1947,96
36085011203,5011203,6791,6654,137,0,1399,1067,4132,113,1299,46,134,2367,2202,165
36085011204,5011204,46,46,0,0,12,8,19,5,7,6,1,23,17,6
36085011401,5011401,3249,3209,40,0,655,757,1458,470,419,48,97,1391,1362,29
36085011402,5011402,3738,3721,17,0,682,526,2450,73,603,27,59,1458,1385,73
36085012100,5012100,3212,3209,3,0,639,384,2539,31,156,15,87,1208,1165,43
36085012200,5012200,3938,3917,21,0,707,446,3055,30,313,32,62,1579,1464,115
36085012500,5012500,3087,3065,22,0,794,1119,1120,410,329,27,82,1049,980,69
36085012804,5012804,4644,4609,35,0,979,804,2882,81,761,32,84,1708,1573,135
36085012805,5012805,2390,2355,35,0,431,215,1757,22,337,25,34,843,802,41
36085012806,5012806,6659,6647,12,0,1385,1015,4130,475,835,50,154,2645,2553,92
36085013201,5013201,1659,1647,12,0,341,122,1325,31,147,11,23,604,581,23
36085013203,5013203,5790,5771,19,0,1093,559,4536,28,524,35,108,2211,2098,113
36085013204,5013204,5055,5044,11,0,937,583,3803,27,508,18,116,2001,1894,107
36085013301,5013301,1631,1631,0,0,584,637,90,768,41,24,71,604,581,23
36085013302,5013302,3733,3702,31,0,1054,1927,376,1075,213,59,83,1143,1054,89
36085013400,5013400,4204,4188,16,0,840,715,2875,60,406,41,107,1667,1577,90
36085013800,5013800,6625,6613,12,0,1259,588,5307,26,539,33,132,2475,2372,103
36085014100,5014100,2868,2854,14,0,684,1139,827,382,367,57,96,1006,967,39
36085014604,5014604,6651,6640,11,0,1239,673,5287,52,513,18,108,2673,2504,169
36085014605,5014605,3785,3776,9,0,678,309,3165,15,222,8,66,1453,1371,82
36085014606,5014606,6288,6279,9,0,1112,740,5039,49,303,30,127,2494,2377,117
36085014607,5014607,4650,4644,6,0,1065,486,3591,30,464,17,62,1732,1655,77
36085014608,5014608,3640,3640,0,0,723,359,2856,6,344,18,57,1312,1252,60
36085014700,5014700,3451,3442,9,0,626,441,2631,79,179,24,97,1525,1417,108
36085015100,5015100,5449,5426,23,0,1208,855,3849,90,445,29,181,2153,2035,118
36085015400,5015400,5,5,0,0,0,0,3,0,0,1,1,1,0,1
36085015601,5015601,6663,6643,20,0,1308,650,5522,45,334,30,82,2584,2476,108
36085015602,5015602,3396,3394,2,0,620,219,2942,9,140,17,69,1221,1170,51
36085015603,5015603,4776,4776,0,0,986,587,3647,26,415,19,82,1819,1708,111
36085016901,5016901,3213,3189,24,0,671,479,1993,90,539,25,87,1170,1110,60
36085017005,5017005,4845,4823,22,0,980,453,3843,36,374,34,105,1899,1759,140
36085017007,5017007,5526,5486,40,0,1347,870,3287,185,1038,24,122,1869,1824,45
36085017009,5017009,4473,4467,6,0,914,385,3788,24,206,20,50,1778,1647,131
36085017011,5017011,4587,4579,8,0,837,477,3612,25,401,22,50,1847,1735,112
36085017012,5017012,4473,4473,0,0,871,512,3385,31,416,23,106,1754,1648,106
36085017013,5017013,4333,4333,0,0,925,728,2902,99,478,26,100,1514,1468,46
36085017014,5017014,4327,4327,0,0,866,579,3315,54,295,22,62,1648,1559,89
36085017015,5017015,2713,2713,0,0,515,279,2204,14,126,31,59,1069,1023,46
36085017016,5017016,4637,4634,3,0,1012,489,3620,14,405,9,100,1645,1597,48
36085017300,5017300,2535,2535,0,0,558,533,804,511,572,19,96,979,948,31
36085017600,5017600,4932,4922,10,0,906,302,4150,17,344,19,100,1854,1751,103
36085017701,5017701,4724,4701,23,0,896,292,3369,40,894,20,109,1639,1549,90
36085017702,5017702,2353,2353,0,0,463,183,1881,15,240,11,23,904,853,51
36085018100,5018100,3569,3212,357,264,581,350,2608,135,379,18,79,1434,1330,104
36085018701,5018701,1836,1836,0,0,407,364,1074,76,240,26,56,676,646,30
36085018703,5018703,3976,3761,215,2,1010,573,1753,266,1246,34,104,1176,1110,66
36085018704,5018704,3780,3466,314,310,800,423,2272,90,884,34,77,1239,1198,41
36085018901,5018901,5725,5688,37,0,1097,792,3693,122,1007,21,90,2189,2065,124
36085018902,5018902,5533,5512,21,0,1525,501,3371,164,1309,98,90,1832,1697,135
36085019700,5019700,1958,1950,8,0,410,225,1463,44,162,23,41,736,709,27
36085019800,5019800,6627,6546,81,21,1366,582,5484,64,350,23,124,2468,2306,162
36085020100,5020100,3796,3787,9,0,893,1166,2020,223,266,40,81,1319,1244,75
36085020701,5020701,3942,3921,21,0,1154,2054,269,1197,255,29,138,1193,1133,60
36085020702,5020702,3436,3410,26,0,947,1947,345,916,126,26,76,1211,1120,91
36085020803,5020803,7348,7225,123,0,1624,674,6049,56,374,60,135,2738,2586,152
36085020804,5020804,5364,5350,14,0,1050,469,4481,13,256,31,114,2072,1942,130
36085020805,5020805,6433,6432,1,0,1323,703,5177,55,383,27,88,2455,2364,91
36085020806,5020806,2714,2701,13,0,559,297,2106,36,209,10,56,993,938,55
36085021300,5021300,5737,5681,56,0,1430,3021,1362,879,297,53,125,1819,1710,109
36085022300,5022300,3134,3104,30,0,791,1244,490,1126,127,53,94,1044,958,86
36085022601,5022601,6945,6930,15,0,1627,790,5468,89,468,19,111,2619,2473,146
36085022602,5022602,1223,1210,13,0,181,167,945,19,68,9,15,507,481,26
36085022801,5022801,95,91,4,0,9,35,31,2,19,1,7,29,27,2
36085022802,5022802,15,15,0,0,4,6,4,3,0,0,2,8,8,0
36085023100,5023100,4959,4761,198,0,1158,1976,848,1230,710,67,128,1528,1437,91
36085023900,5023900,3605,3588,17,0,754,1563,780,688,392,60,122,1179,1115,64
36085024401,5024401,5687,5664,23,0,1188,552,4801,39,138,36,121,2170,2007,163
36085024402,5024402,4381,4372,9,0,861,356,3803,21,106,15,80,1773,1625,148
36085024700,5024700,2893,2879,14,0,712,1003,810,675,309,16,80,1019,967,52
36085024800,5024800,4798,4785,13,0,1111,816,3637,57,127,49,112,1877,1705,172
36085025100,5025100,6030,6004,26,0,1164,909,4162,131,667,12,149,2278,2160,118
36085027301,5027301,4811,4296,515,0,920,607,2928,140,1007,45,84,1710,1620,90
36085027302,5027302,4242,4236,6,1,1296,317,2850,125,847,46,57,1410,1287,123
36085027702,5027702,6479,6470,9,0,1014,996,3925,250,1123,41,144,3068,2951,117
36085027704,5027704,4612,4612,0,0,953,492,2713,116,1194,37,60,1639,1517,122
36085027705,5027705,5866,5866,0,0,1259,811,3214,112,1578,30,121,2018,1891,127
36085027706,5027706,3043,3043,0,0,631,441,1743,97,673,11,78,1173,1098,75
36085027900,5027900,2110,1821,289,289,348,248,1689,2,115,4,52,680,651,29
36085029102,5029102,3394,3381,13,0,844,748,1963,111,459,30,83,1127,1065,62
36085029104,5029104,7178,7148,30,0,1502,1308,4101,303,1270,44,152,2535,2406,129
36085029105,5029105,4257,4232,25,0,790,578,2813,67,682,23,94,1674,1569,105
36085029106,5029106,3231,3231,0,0,634,556,2102,99,415,14,45,1173,1103,70
36085030301,5030301,5130,5104,26,9,1033,1427,2022,680,839,54,108,1876,1819,57
36085030302,5030302,6669,6649,20,0,1532,2306,1622,1284,1219,80,158,2096,2001,95
36085031901,5031901,3262,3248,14,0,988,1218,179,1526,181,30,128,1122,1080,42
36085031902,5031902,5500,5459,41,7,1717,1722,472,2904,111,85,206,1864,1769,95
36085032300,5032300,1233,1233,0,0,285,454,205,415,80,24,55,498,461,37
36085990100,5990100,0,0,0,0,0,0,0,0,0,0,0,0,0,0
